AAAAAAGTGCTGTTCTCCCA -> AAAAAGTGCTGTTCTCCCAC
AAAAAGTGCTGTTCTCCCAC -> AAAAGTGCTGTTCTCCCACA
AAAAGGTCAGGAATATATTC -> AAAGGTCAGGAATATATTCT
AAAAGTGCTGTTCTCCCACA -> AAAGTGCTGTTCTCCCACAC
AAAATACGAGGCGAAGCTGC -> AAATACGAGGCGAAGCTGCA
AAACGCAGGATGGGAATATA -> AACGCAGGATGGGAATATAA
AAACGCCAGGTTGATTTTAC -> AACGCCAGGTTGATTTTACC
AAACGCCGAAAAAAGTGCTG -> AACGCCGAAAAAAGTGCTGT
AAACTACGCCACTTACTCTC -> AACTACGCCACTTACTCTCG
AAACTTGTAAAGAGGTGGAA -> AACTTGTAAAGAGGTGGAAC
AAAGAGGTGGAACTATGCTG -> AAGAGGTGGAACTATGCTGG
AAAGGTCAGGAATATATTCT -> AAGGTCAGGAATATATTCTA
AAAGGTTTCTTACGGACAAT -> AAGGTTTCTTACGGACAATG
AAAGTGCTGTTCTCCCACAC -> AAGTGCTGTTCTCCCACACC
AAAGTTGATGCCCCACTAGT -> AAGTTGATGCCCCACTAGTA
AAATACGAGGCGAAGCTGCA -> AATACGAGGCGAAGCTGCAT
AAATAGCACTTCTATGACGT -> AATAGCACTTCTATGACGTT
AAATCAAGTGAACCACGATG -> AATCAAGTGAACCACGATGT
AAATGGTAGGCGTCCGTCGG -> AATGGTAGGCGTCCGTCGGT
AACAACATTTATGGCTGCAT -> ACAACATTTATGGCTGCATA
AACAATGCTAAGGTGCCGCT -> ACAATGCTAAGGTGCCGCTA
AACACGGGCGGTTGGAAGAC -> ACACGGGCGGTTGGAAGACA
AACATTTATGGCTGCATAGA -> ACATTTATGGCTGCATAGAA
AACCAATGTGTCTTGTGCTA -> ACCAATGTGTCTTGTGCTAC
AACCACGATGTGGACATCTC -> ACCACGATGTGGACATCTCC
AACCGTGTCTAGCGTGGCAT -> ACCGTGTCTAGCGTGGCATA
AACCGTTAGTGAATATACCC -> ACCGTTAGTGAATATACCCC
AACGAAAGGTTTCTTACGGA -> ACGAAAGGTTTCTTACGGAC
AACGCAGGATGGGAATATAA -> ACGCAGGATGGGAATATAAT
AACGCCAGGTTGATTTTACC -> ACGCCAGGTTGATTTTACCT
AACGCCGAAAAAAGTGCTGT -> ACGCCGAAAAAAGTGCTGTT
AACTACACATGTGAGTACCC -> ACTACACATGTGAGTACCCC
AACTACGCCACTTACTCTCG -> ACTACGCCACTTACTCTCGT
AACTAGGTCTAATATTGGGA -> ACTAGGTCTAATATTGGGAG
AACTATGCTGGACAGCTAAC -> ACTATGCTGGACAGCTAACT
AACTTGTAAAGAGGTGGAAC -> ACTTGTAAAGAGGTGGAACT
AAGACAAAGTTGATGCCCCA -> AGACAAAGTTGATGCCCCAC
AAGAGATCACACTAACAATG -> AGAGATCACACTAACAATGC
AAGAGGTGGAACTATGCTGG -> AGAGGTGGAACTATGCTGGA
AAGATGTCCGATTTACCAGC -> AGATGTCCGATTTACCAGCT
AAGCGCTCCCAGTACGCTGC -> AGCGCTCCCAGTACGCTGCC
AAGGAAACGCCGAAAAAAGT -> AGGAAACGCCGAAAAAAGTG
AAGGGGATAGTCAACCAATG -> AGGGGATAGTCAACCAATGT
AAGGTCAGGAATATATTCTA -> AGGTCAGGAATATATTCTAA
AAGGTGCCGCTATAGACTGA -> AGGTGCCGCTATAGACTGAG
AAGGTTTCTTACGGACAATG -> AGGTTTCTTACGGACAATGG
AAGTCTAGGGCGCCCCTGTA -> AGTCTAGGGCGCCCCTGTAA
AAGTGAACCACGATGTGGAC -> AGTGAACCACGATGTGGACA
AAGTGAGTTAGTATGGCGTG -> AGTGAGTTAGTATGGCGTGC
AAGTGCTGTTCTCCCACACC -> AGTGCTGTTCTCCCACACCT
AAGTGGTATTCTTCGGCGGC -> AGTGGTATTCTTCGGCGGCA
AAGTTGATGCCCCACTAGTA -> AGTTGATGCCCCACTAGTAC
AATAAGTGAGTTAGTATGGC -> ATAAGTGAGTTAGTATGGCG
AATAGCACTTCTATGACGTT -> ATAGCACTTCTATGACGTTA
AATATAATTCTAGCGTATAC -> ATATAATTCTAGCGTATACG
AATATACCCCGTCGTGAAAC -> ATATACCCCGTCGTGAAACT
AATATATTCTAATCTCGAAA -> ATATATTCTAATCTCGAAAT
AATATTGGGAGGCACTAATC -> ATATTGGGAGGCACTAATCC
AATCAAGTGAACCACGATGT -> ATCAAGTGAACCACGATGTG
AATCCCACGGGTGAGACGCC -> ATCCCACGGGTGAGACGCCT
AATCCGACGATCTCGTTAGG -> ATCCGACGATCTCGTTAGGC
AATCCTATGCAGTGAAACTA -> ATCCTATGCAGTGAAACTAC
AATCTCGAAATGGTAGGCGT -> ATCTCGAAATGGTAGGCGTC
AATGCTAAGGTGCCGCTATA -> ATGCTAAGGTGCCGCTATAG
AATGGCTCAATCCCACGGGT -> ATGGCTCAATCCCACGGGTG
AATGGTAGGCGTCCGTCGGT -> ATGGTAGGCGTCCGTCGGTA
AATGTGTCTTGTGCTACGTT -> ATGTGTCTTGTGCTACGTTT
AATTACGTGCCCTTCTAAAA -> ATTACGTGCCCTTCTAAAAG
AATTCTAGCGTATACGATAC -> ATTCTAGCGTATACGATACA
AATTTGGGTGGGCTATAGGT -> ATTTGGGTGGGCTATAGGTT
ACAAAGTTGATGCCCCACTA -> CAAAGTTGATGCCCCACTAG
ACAACATTTATGGCTGCATA -> CAACATTTATGGCTGCATAG
ACAATGCTAAGGTGCCGCTA -> CAATGCTAAGGTGCCGCTAT
ACAATGGCTCAATCCCACGG -> CAATGGCTCAATCCCACGGG
ACACATGTGAGTACCCCGCG -> CACATGTGAGTACCCCGCGT
ACACCTTATCAACAACATTT -> CACCTTATCAACAACATTTA
ACACGCTTGTAGGTGACATA -> CACGCTTGTAGGTGACATAA
ACACGGGCGGTTGGAAGACA -> CACGGGCGGTTGGAAGACAA
ACACTAACAATGCTAAGGTG -> CACTAACAATGCTAAGGTGC
ACACTGGAGCCAGGACCCCG -> CACTGGAGCCAGGACCCCGA
ACAGCTAACTACACATGTGA -> CAGCTAACTACACATGTGAG
ACAGGACTTGCCGGTGTCTG -> CAGGACTTGCCGGTGTCTGG
ACATAAATAGCACTTCTATG -> CATAAATAGCACTTCTATGA
ACATCTCCCCAGATCACGAC -> CATCTCCCCAGATCACGACT
ACATGTGAGTACCCCGCGTA -> CATGTGAGTACCCCGCGTAT
ACATTAACACGGGCGGTTGG -> CATTAACACGGGCGGTTGGA
ACATTAGTATACCTCACCAA -> CATTAGTATACCTCACCAAT
ACATTTATGGCTGCATAGAA -> CATTTATGGCTGCATAGAAC
ACCAACTAGGTCTAATATTG -> CCAACTAGGTCTAATATTGG
ACCAATCCTATGCAGTGAAA -> CCAATCCTATGCAGTGAAAC
ACCAATGTGTCTTGTGCTAC -> CCAATGTGTCTTGTGCTACG
ACCACGATGTGGACATCTCC -> CCACGATGTGGACATCTCCC
ACCAGCTGCGGCCGGACGAG -> CCAGCTGCGGCCGGACGAGT
ACCCAACCGTGTCTAGCGTG -> CCCAACCGTGTCTAGCGTGG
ACCCCGAGGTACGCAATTTG -> CCCCGAGGTACGCAATTTGG
ACCCCGCGTATGTTTGAGTT -> CCCCGCGTATGTTTGAGTTG
ACCCCGTCGTGAAACTTGTA -> CCCCGTCGTGAAACTTGTAA
ACCCGCAAGATGTCCGATTT -> CCCGCAAGATGTCCGATTTA
ACCCGGAAGAGATCACACTA -> CCCGGAAGAGATCACACTAA
ACCGTGTCTAGCGTGGCATA -> CCGTGTCTAGCGTGGCATAC
ACCGTTAGTGAATATACCCC -> CCGTTAGTGAATATACCCCG
ACCTCACCAATCCTATGCAG -> CCTCACCAATCCTATGCAGT
ACCTGTTCGATAAACGCAGG -> CCTGTTCGATAAACGCAGGA
ACCTTATCAACAACATTTAT -> CCTTATCAACAACATTTATG
ACGAAAGGTTTCTTACGGAC -> CGAAAGGTTTCTTACGGACA
ACGAAGTGGTATTCTTCGGC -> CGAAGTGGTATTCTTCGGCG
ACGACTCTCAGTCCCAAGGA -> CGACTCTCAGTCCCAAGGAA
ACGAGTGAGCAGTTGAAAAT -> CGAGTGAGCAGTTGAAAATA
ACGATACATTAACACGGGCG -> CGATACATTAACACGGGCGG
ACGATCTCGTTAGGCGCGAC -> CGATCTCGTTAGGCGCGACA
ACGATGTGGACATCTCCCCA -> CGATGTGGACATCTCCCCAG
ACGCAATTTGGGTGGGCTAT -> CGCAATTTGGGTGGGCTATA
ACGCAGGATGGGAATATAAT -> CGCAGGATGGGAATATAATT
ACGCCACTTACTCTCGTACT -> CGCCACTTACTCTCGTACTA
ACGCCAGGTTGATTTTACCT -> CGCCAGGTTGATTTTACCTG
ACGCCGAAAAAAGTGCTGTT -> CGCCGAAAAAAGTGCTGTTC
ACGCCTAATAAGTGAGTTAG -> CGCCTAATAAGTGAGTTAGT
ACGCTGCCCGTGAGAGTGTA -> CGCTGCCCGTGAGAGTGTAG
ACGCTTGTAGGTGACATAAA -> CGCTTGTAGGTGACATAAAT
ACGGACAATGGCTCAATCCC -> CGGACAATGGCTCAATCCCA
ACGGGCGGTTGGAAGACAAA -> CGGGCGGTTGGAAGACAAAG
ACGGGTGAGACGCCTAATAA -> CGGGTGAGACGCCTAATAAG
ACGTGCCCTTCTAAAAGGTC -> CGTGCCCTTCTAAAAGGTCA
ACGTTACCCGCAAGATGTCC -> CGTTACCCGCAAGATGTCCG
ACGTTTCGACGAAGTGGTAT -> CGTTTCGACGAAGTGGTATT
ACTAACAATGCTAAGGTGCC -> CTAACAATGCTAAGGTGCCG
ACTAATCCGACGATCTCGTT -> CTAATCCGACGATCTCGTTA
ACTACACATGTGAGTACCCC -> CTACACATGTGAGTACCCCG
ACTACGCCACTTACTCTCGT -> CTACGCCACTTACTCTCGTA
ACTAGCCCGCGAAGCGCTCC -> CTAGCCCGCGAAGCGCTCCC
ACTAGGTCTAATATTGGGAG -> CTAGGTCTAATATTGGGAGG
ACTAGTACTCATATACACGC -> CTAGTACTCATATACACGCT
ACTATGCTGGACAGCTAACT -> CTATGCTGGACAGCTAACTA
ACTCATATACACGCTTGTAG -> CTCATATACACGCTTGTAGG
ACTCTCAGTCCCAAGGAAAC -> CTCTCAGTCCCAAGGAAACG
ACTCTCGTACTAGCCCGCGA -> CTCTCGTACTAGCCCGCGAA
ACTGAGGCGTCGCAAGTCTA -> CTGAGGCGTCGCAAGTCTAG
ACTGGAGCCAGGACCCCGAG -> CTGGAGCCAGGACCCCGAGG
ACTTACTCTCGTACTAGCCC -> CTTACTCTCGTACTAGCCCG
ACTTCTATGACGTTACCCGC -> CTTCTATGACGTTACCCGCA
ACTTGCCGGTGTCTGGGTTG -> CTTGCCGGTGTCTGGGTTGG
ACTTGTAAAGAGGTGGAACT -> CTTGTAAAGAGGTGGAACTA
AGAAATCAAGTGAACCACGA -> GAAATCAAGTGAACCACGAT
AGAACGAAAGGTTTCTTACG -> GAACGAAAGGTTTCTTACGG
AGACAAAGTTGATGCCCCAC -> GACAAAGTTGATGCCCCACT
AGACGCCTAATAAGTGAGTT -> GACGCCTAATAAGTGAGTTA
AGACTGAGGCGTCGCAAGTC -> GACTGAGGCGTCGCAAGTCT
AGAGATCACACTAACAATGC -> GAGATCACACTAACAATGCT
AGAGGTGGAACTATGCTGGA -> GAGGTGGAACTATGCTGGAC
AGAGTGTAGAAATCAAGTGA -> GAGTGTAGAAATCAAGTGAA
AGATCACACTAACAATGCTA -> GATCACACTAACAATGCTAA
AGATCACGACTCTCAGTCCC -> GATCACGACTCTCAGTCCCA
AGATGTCCGATTTACCAGCT -> GATGTCCGATTTACCAGCTG
AGCACTTCTATGACGTTACC -> GCACTTCTATGACGTTACCC
AGCAGTTGAAAATACGAGGC -> GCAGTTGAAAATACGAGGCG
AGCCAGGACCCCGAGGTACG -> GCCAGGACCCCGAGGTACGC
AGCCCGCGAAGCGCTCCCAG -> GCCCGCGAAGCGCTCCCAGT
AGCGCTCCCAGTACGCTGCC -> GCGCTCCCAGTACGCTGCCC
AGCGTATACGATACATTAAC -> GCGTATACGATACATTAACA
AGCGTGGCATACCAACTAGG -> GCGTGGCATACCAACTAGGT
AGCTAACTACACATGTGAGT -> GCTAACTACACATGTGAGTA
AGCTGCGGCCGGACGAGTGA -> GCTGCGGCCGGACGAGTGAG
AGGAAACGCCGAAAAAAGTG -> GGAAACGCCGAAAAAAGTGC
AGGAATATATTCTAATCTCG -> GGAATATATTCTAATCTCGA
AGGACCCCGAGGTACGCAAT -> GGACCCCGAGGTACGCAATT
AGGACTTGCCGGTGTCTGGG -> GGACTTGCCGGTGTCTGGGT
AGGATGGGAATATAATTCTA -> GGATGGGAATATAATTCTAG
AGGCACTAATCCGACGATCT -> GGCACTAATCCGACGATCTC
AGGCGCGACAGGACTTGCCG -> GGCGCGACAGGACTTGCCGG
AGGCGTCCGTCGGTAAACGC -> GGCGTCCGTCGGTAAACGCC
AGGCGTCGCAAGTCTAGGGC -> GGCGTCGCAAGTCTAGGGCG
AGGGCGCCCCTGTAAGGGGA -> GGGCGCCCCTGTAAGGGGAT
AGGGGATAGTCAACCAATGT -> GGGGATAGTCAACCAATGTG
AGGTACGCAATTTGGGTGGG -> GGTACGCAATTTGGGTGGGC
AGGTCAGGAATATATTCTAA -> GGTCAGGAATATATTCTAAT
AGGTCTAATATTGGGAGGCA -> GGTCTAATATTGGGAGGCAC
AGGTGACATAAATAGCACTT -> GGTGACATAAATAGCACTTC
AGGTGCCGCTATAGACTGAG -> GGTGCCGCTATAGACTGAGG
AGGTGGAACTATGCTGGACA -> GGTGGAACTATGCTGGACAG
AGGTTGATTTTACCTGTTCG -> GGTTGATTTTACCTGTTCGA
AGGTTTCTTACGGACAATGG -> GGTTTCTTACGGACAATGGC
AGGTTTGCACCCAACCGTGT -> GGTTTGCACCCAACCGTGTC
AGTACCCCGCGTATGTTTGA -> GTACCCCGCGTATGTTTGAG
AGTACGCTGCCCGTGAGAGT -> GTACGCTGCCCGTGAGAGTG
AGTACTCATATACACGCTTG -> GTACTCATATACACGCTTGT
AGTATACCTCACCAATCCTA -> GTATACCTCACCAATCCTAT
AGTATGGCGTGCATATAGTG -> GTATGGCGTGCATATAGTGT
AGTCAACCAATGTGTCTTGT -> GTCAACCAATGTGTCTTGTG
AGTCCCAAGGAAACGCCGAA -> GTCCCAAGGAAACGCCGAAA
AGTCTAGGGCGCCCCTGTAA -> GTCTAGGGCGCCCCTGTAAG
AGTGAAACTACGCCACTTAC -> GTGAAACTACGCCACTTACT
AGTGAACCACGATGTGGACA -> GTGAACCACGATGTGGACAT
AGTGAATATACCCCGTCGTG -> GTGAATATACCCCGTCGTGA
AGTGAGCAGTTGAAAATACG -> GTGAGCAGTTGAAAATACGA
AGTGAGTTAGTATGGCGTGC -> GTGAGTTAGTATGGCGTGCA
AGTGCTGTTCTCCCACACCT -> GTGCTGTTCTCCCACACCTT
AGTGGTATTCTTCGGCGGCA -> GTGGTATTCTTCGGCGGCAA
AGTGTAGAAATCAAGTGAAC -> GTGTAGAAATCAAGTGAACC
AGTGTTGATACACTGGAGCC -> GTGTTGATACACTGGAGCCA
AGTTAGTATGGCGTGCATAT -> GTTAGTATGGCGTGCATATA
AGTTGAAAATACGAGGCGAA -> GTTGAAAATACGAGGCGAAG
AGTTGATGCCCCACTAGTAC -> GTTGATGCCCCACTAGTACT
AGTTGATGGACATTAGTATA -> GTTGATGGACATTAGTATAC
ATAAACGCAGGATGGGAATA -> TAAACGCAGGATGGGAATAT
ATAAATAGCACTTCTATGAC -> TAAATAGCACTTCTATGACG
ATAAGTGAGTTAGTATGGCG -> TAAGTGAGTTAGTATGGCGT
ATAATTCTAGCGTATACGAT -> TAATTCTAGCGTATACGATA
ATACACGCTTGTAGGTGACA -> TACACGCTTGTAGGTGACAT
ATACACTGGAGCCAGGACCC -> TACACTGGAGCCAGGACCCC
ATACATTAACACGGGCGGTT -> TACATTAACACGGGCGGTTG
ATACCAACTAGGTCTAATAT -> TACCAACTAGGTCTAATATT
ATACCCCGTCGTGAAACTTG -> TACCCCGTCGTGAAACTTGT
ATACCTCACCAATCCTATGC -> TACCTCACCAATCCTATGCA
ATACGATACATTAACACGGG -> TACGATACATTAACACGGGC
ATAGAACGAAAGGTTTCTTA -> TAGAACGAAAGGTTTCTTAC
ATAGACTGAGGCGTCGCAAG -> TAGACTGAGGCGTCGCAAGT
ATAGCACTTCTATGACGTTA -> TAGCACTTCTATGACGTTAC
ATAGGTTTGCACCCAACCGT -> TAGGTTTGCACCCAACCGTG
ATAGTCAACCAATGTGTCTT -> TAGTCAACCAATGTGTCTTG
ATAGTGTTGATACACTGGAG -> TAGTGTTGATACACTGGAGC
ATATAATTCTAGCGTATACG -> TATAATTCTAGCGTATACGA
ATATACACGCTTGTAGGTGA -> TATACACGCTTGTAGGTGAC
ATATACCCCGTCGTGAAACT -> TATACCCCGTCGTGAAACTT
ATATAGTGTTGATACACTGG -> TATAGTGTTGATACACTGGA
ATATATTCTAATCTCGAAAT -> TATATTCTAATCTCGAAATG
ATATTCTAATCTCGAAATGG -> TATTCTAATCTCGAAATGGT
ATATTGGGAGGCACTAATCC -> TATTGGGAGGCACTAATCCG
ATCAACAACATTTATGGCTG -> TCAACAACATTTATGGCTGC
ATCAAGTGAACCACGATGTG -> TCAAGTGAACCACGATGTGG
ATCACACTAACAATGCTAAG -> TCACACTAACAATGCTAAGG
ATCACGACTCTCAGTCCCAA -> TCACGACTCTCAGTCCCAAG
ATCCCACGGGTGAGACGCCT -> TCCCACGGGTGAGACGCCTA
ATCCGACGATCTCGTTAGGC -> TCCGACGATCTCGTTAGGCG
ATCCTATGCAGTGAAACTAC -> TCCTATGCAGTGAAACTACG
ATCTCCCCAGATCACGACTC -> TCTCCCCAGATCACGACTCT
ATCTCGAAATGGTAGGCGTC -> TCTCGAAATGGTAGGCGTCC
ATCTCGTTAGGCGCGACAGG -> TCTCGTTAGGCGCGACAGGA
ATGACGTTACCCGCAAGATG -> TGACGTTACCCGCAAGATGT
ATGCAGTGAAACTACGCCAC -> TGCAGTGAAACTACGCCACT
ATGCCCCACTAGTACTCATA -> TGCCCCACTAGTACTCATAT
ATGCTAAGGTGCCGCTATAG -> TGCTAAGGTGCCGCTATAGA
ATGCTGGACAGCTAACTACA -> TGCTGGACAGCTAACTACAC
ATGGACATTAGTATACCTCA -> TGGACATTAGTATACCTCAC
ATGGCGTGCATATAGTGTTG -> TGGCGTGCATATAGTGTTGA
ATGGCTCAATCCCACGGGTG -> TGGCTCAATCCCACGGGTGA
ATGGCTGCATAGAACGAAAG -> TGGCTGCATAGAACGAAAGG
ATGGGAATATAATTCTAGCG -> TGGGAATATAATTCTAGCGT
ATGGTAGGCGTCCGTCGGTA -> TGGTAGGCGTCCGTCGGTAA
ATGTCCGATTTACCAGCTGC -> TGTCCGATTTACCAGCTGCG
ATGTGAGTACCCCGCGTATG -> TGTGAGTACCCCGCGTATGT
ATGTGGACATCTCCCCAGAT -> TGTGGACATCTCCCCAGATC
ATGTGTCTTGTGCTACGTTT -> TGTGTCTTGTGCTACGTTTC
ATGTTTGAGTTGATGGACAT -> TGTTTGAGTTGATGGACATT
ATTAACACGGGCGGTTGGAA -> TTAACACGGGCGGTTGGAAG
ATTACGTGCCCTTCTAAAAG -> TTACGTGCCCTTCTAAAAGG
ATTAGTATACCTCACCAATC -> TTAGTATACCTCACCAATCC
ATTCTAATCTCGAAATGGTA -> TTCTAATCTCGAAATGGTAG
ATTCTAGCGTATACGATACA -> TTCTAGCGTATACGATACAT
ATTCTTCGGCGGCAATTACG -> TTCTTCGGCGGCAATTACGT
ATTGGGAGGCACTAATCCGA -> TTGGGAGGCACTAATCCGAC
ATTTACCAGCTGCGGCCGGA -> TTTACCAGCTGCGGCCGGAC
ATTTATGGCTGCATAGAACG -> TTTATGGCTGCATAGAACGA
ATTTGGGTGGGCTATAGGTT -> TTTGGGTGGGCTATAGGTTT
ATTTTACCTGTTCGATAAAC -> TTTTACCTGTTCGATAAACG
CAAAGTTGATGCCCCACTAG -> AAAGTTGATGCCCCACTAGT
CAACAACATTTATGGCTGCA -> AACAACATTTATGGCTGCAT
CAACATTTATGGCTGCATAG -> AACATTTATGGCTGCATAGA
CAACCAATGTGTCTTGTGCT -> AACCAATGTGTCTTGTGCTA
CAACCGTGTCTAGCGTGGCA -> AACCGTGTCTAGCGTGGCAT
CAACTAGGTCTAATATTGGG -> AACTAGGTCTAATATTGGGA
CAAGATGTCCGATTTACCAG -> AAGATGTCCGATTTACCAGC
CAAGGAAACGCCGAAAAAAG -> AAGGAAACGCCGAAAAAAGT
CAAGTCTAGGGCGCCCCTGT -> AAGTCTAGGGCGCCCCTGTA
CAAGTGAACCACGATGTGGA -> AAGTGAACCACGATGTGGAC
CAATCCCACGGGTGAGACGC -> AATCCCACGGGTGAGACGCC
CAATCCTATGCAGTGAAACT -> AATCCTATGCAGTGAAACTA
CAATGCTAAGGTGCCGCTAT -> AATGCTAAGGTGCCGCTATA
CAATGGCTCAATCCCACGGG -> AATGGCTCAATCCCACGGGT
CAATGTGTCTTGTGCTACGT -> AATGTGTCTTGTGCTACGTT
CAATTACGTGCCCTTCTAAA -> AATTACGTGCCCTTCTAAAA
CAATTTGGGTGGGCTATAGG -> AATTTGGGTGGGCTATAGGT
CACACCTTATCAACAACATT -> ACACCTTATCAACAACATTT
CACACTAACAATGCTAAGGT -> ACACTAACAATGCTAAGGTG
CACATGTGAGTACCCCGCGT -> ACATGTGAGTACCCCGCGTA
CACCAATCCTATGCAGTGAA -> ACCAATCCTATGCAGTGAAA
CACCCAACCGTGTCTAGCGT -> ACCCAACCGTGTCTAGCGTG
CACCTTATCAACAACATTTA -> ACCTTATCAACAACATTTAT
CACGACTCTCAGTCCCAAGG -> ACGACTCTCAGTCCCAAGGA
CACGATGTGGACATCTCCCC -> ACGATGTGGACATCTCCCCA
CACGCTTGTAGGTGACATAA -> ACGCTTGTAGGTGACATAAA
CACGGGCGGTTGGAAGACAA -> ACGGGCGGTTGGAAGACAAA
CACGGGTGAGACGCCTAATA -> ACGGGTGAGACGCCTAATAA
CACTAACAATGCTAAGGTGC -> ACTAACAATGCTAAGGTGCC
CACTAATCCGACGATCTCGT -> ACTAATCCGACGATCTCGTT
CACTAGTACTCATATACACG -> ACTAGTACTCATATACACGC
CACTGGAGCCAGGACCCCGA -> ACTGGAGCCAGGACCCCGAG
CACTTACTCTCGTACTAGCC -> ACTTACTCTCGTACTAGCCC
CACTTCTATGACGTTACCCG -> ACTTCTATGACGTTACCCGC
CAGATCACGACTCTCAGTCC -> AGATCACGACTCTCAGTCCC
CAGCTAACTACACATGTGAG -> AGCTAACTACACATGTGAGT
CAGCTGCGGCCGGACGAGTG -> AGCTGCGGCCGGACGAGTGA
CAGGAATATATTCTAATCTC -> AGGAATATATTCTAATCTCG
CAGGACCCCGAGGTACGCAA -> AGGACCCCGAGGTACGCAAT
CAGGACTTGCCGGTGTCTGG -> AGGACTTGCCGGTGTCTGGG
CAGGATGGGAATATAATTCT -> AGGATGGGAATATAATTCTA
CAGGTTGATTTTACCTGTTC -> AGGTTGATTTTACCTGTTCG
CAGTACGCTGCCCGTGAGAG -> AGTACGCTGCCCGTGAGAGT
CAGTCCCAAGGAAACGCCGA -> AGTCCCAAGGAAACGCCGAA
CAGTGAAACTACGCCACTTA -> AGTGAAACTACGCCACTTAC
CAGTTGAAAATACGAGGCGA -> AGTTGAAAATACGAGGCGAA
CATAAATAGCACTTCTATGA -> ATAAATAGCACTTCTATGAC
CATACCAACTAGGTCTAATA -> ATACCAACTAGGTCTAATAT
CATAGAACGAAAGGTTTCTT -> ATAGAACGAAAGGTTTCTTA
CATATACACGCTTGTAGGTG -> ATATACACGCTTGTAGGTGA
CATATAGTGTTGATACACTG -> ATATAGTGTTGATACACTGG
CATCTCCCCAGATCACGACT -> ATCTCCCCAGATCACGACTC
CATGTGAGTACCCCGCGTAT -> ATGTGAGTACCCCGCGTATG
CATTAACACGGGCGGTTGGA -> ATTAACACGGGCGGTTGGAA
CATTAGTATACCTCACCAAT -> ATTAGTATACCTCACCAATC
CATTTATGGCTGCATAGAAC -> ATTTATGGCTGCATAGAACG
CCAACCGTGTCTAGCGTGGC -> CAACCGTGTCTAGCGTGGCA
CCAACTAGGTCTAATATTGG -> CAACTAGGTCTAATATTGGG
CCAAGGAAACGCCGAAAAAA -> CAAGGAAACGCCGAAAAAAG
CCAATCCTATGCAGTGAAAC -> CAATCCTATGCAGTGAAACT
CCAATGTGTCTTGTGCTACG -> CAATGTGTCTTGTGCTACGT
CCACACCTTATCAACAACAT -> CACACCTTATCAACAACATT
CCACGATGTGGACATCTCCC -> CACGATGTGGACATCTCCCC
CCACGGGTGAGACGCCTAAT -> CACGGGTGAGACGCCTAATA
CCACTAGTACTCATATACAC -> CACTAGTACTCATATACACG
CCACTTACTCTCGTACTAGC -> CACTTACTCTCGTACTAGCC
CCAGATCACGACTCTCAGTC -> CAGATCACGACTCTCAGTCC
CCAGCTGCGGCCGGACGAGT -> CAGCTGCGGCCGGACGAGTG
CCAGGACCCCGAGGTACGCA -> CAGGACCCCGAGGTACGCAA
CCAGGTTGATTTTACCTGTT -> CAGGTTGATTTTACCTGTTC
CCAGTACGCTGCCCGTGAGA -> CAGTACGCTGCCCGTGAGAG
CCCAACCGTGTCTAGCGTGG -> CCAACCGTGTCTAGCGTGGC
CCCAAGGAAACGCCGAAAAA -> CCAAGGAAACGCCGAAAAAA
CCCACACCTTATCAACAACA -> CCACACCTTATCAACAACAT
CCCACGGGTGAGACGCCTAA -> CCACGGGTGAGACGCCTAAT
CCCACTAGTACTCATATACA -> CCACTAGTACTCATATACAC
CCCAGATCACGACTCTCAGT -> CCAGATCACGACTCTCAGTC
CCCAGTACGCTGCCCGTGAG -> CCAGTACGCTGCCCGTGAGA
CCCCACTAGTACTCATATAC -> CCCACTAGTACTCATATACA
CCCCAGATCACGACTCTCAG -> CCCAGATCACGACTCTCAGT
CCCCGAGGTACGCAATTTGG -> CCCGAGGTACGCAATTTGGG
CCCCGCGTATGTTTGAGTTG -> CCCGCGTATGTTTGAGTTGA
CCCCGTCGTGAAACTTGTAA -> CCCGTCGTGAAACTTGTAAA
CCCCTGTAAGGGGATAGTCA -> CCCTGTAAGGGGATAGTCAA
CCCGAGGTACGCAATTTGGG -> CCGAGGTACGCAATTTGGGT
CCCGCAAGATGTCCGATTTA -> CCGCAAGATGTCCGATTTAC
CCCGCGAAGCGCTCCCAGTA -> CCGCGAAGCGCTCCCAGTAC
CCCGCGTATGTTTGAGTTGA -> CCGCGTATGTTTGAGTTGAT
CCCGGAAGAGATCACACTAA -> CCGGAAGAGATCACACTAAC
CCCGTCGTGAAACTTGTAAA -> CCGTCGTGAAACTTGTAAAG
CCCGTGAGAGTGTAGAAATC -> CCGTGAGAGTGTAGAAATCA
CCCTGTAAGGGGATAGTCAA -> CCTGTAAGGGGATAGTCAAC
CCCTTCTAAAAGGTCAGGAA -> CCTTCTAAAAGGTCAGGAAT
CCGAAAAAAGTGCTGTTCTC -> CGAAAAAAGTGCTGTTCTCC
CCGACGATCTCGTTAGGCGC -> CGACGATCTCGTTAGGCGCG
CCGAGGTACGCAATTTGGGT -> CGAGGTACGCAATTTGGGTG
CCGATTTACCAGCTGCGGCC -> CGATTTACCAGCTGCGGCCG
CCGCAAGATGTCCGATTTAC -> CGCAAGATGTCCGATTTACC
CCGCGAAGCGCTCCCAGTAC -> CGCGAAGCGCTCCCAGTACG
CCGCGTATGTTTGAGTTGAT -> CGCGTATGTTTGAGTTGATG
CCGCTATAGACTGAGGCGTC -> CGCTATAGACTGAGGCGTCG
CCGGAAGAGATCACACTAAC -> CGGAAGAGATCACACTAACA
CCGGACGAGTGAGCAGTTGA -> CGGACGAGTGAGCAGTTGAA
CCGGTGTCTGGGTTGGCCTT -> CGGTGTCTGGGTTGGCCTTT
CCGTCGGTAAACGCCAGGTT -> CGTCGGTAAACGCCAGGTTG
CCGTCGTGAAACTTGTAAAG -> CGTCGTGAAACTTGTAAAGA
CCGTGAGAGTGTAGAAATCA -> CGTGAGAGTGTAGAAATCAA
CCGTGTCTAGCGTGGCATAC -> CGTGTCTAGCGTGGCATACC
CCGTTAGTGAATATACCCCG -> CGTTAGTGAATATACCCCGT
CCTAATAAGTGAGTTAGTAT -> CTAATAAGTGAGTTAGTATG
CCTATGCAGTGAAACTACGC -> CTATGCAGTGAAACTACGCC
CCTCACCAATCCTATGCAGT -> CTCACCAATCCTATGCAGTG
CCTGTAAGGGGATAGTCAAC -> CTGTAAGGGGATAGTCAACC
CCTGTTCGATAAACGCAGGA -> CTGTTCGATAAACGCAGGAT
CCTTATCAACAACATTTATG -> CTTATCAACAACATTTATGG
CCTTCTAAAAGGTCAGGAAT -> CTTCTAAAAGGTCAGGAATA
CCTTTACCCGGAAGAGATCA -> CTTTACCCGGAAGAGATCAC
CGAAAAAAGTGCTGTTCTCC -> GAAAAAAGTGCTGTTCTCCC
CGAAAGGTTTCTTACGGACA -> GAAAGGTTTCTTACGGACAA
CGAAATGGTAGGCGTCCGTC -> GAAATGGTAGGCGTCCGTCG
CGAAGCGCTCCCAGTACGCT -> GAAGCGCTCCCAGTACGCTG
CGAAGTGGTATTCTTCGGCG -> GAAGTGGTATTCTTCGGCGG
CGACAGGACTTGCCGGTGTC -> GACAGGACTTGCCGGTGTCT
CGACGAAGTGGTATTCTTCG -> GACGAAGTGGTATTCTTCGG
CGACGATCTCGTTAGGCGCG -> GACGATCTCGTTAGGCGCGA
CGACTCTCAGTCCCAAGGAA -> GACTCTCAGTCCCAAGGAAA
CGAGGTACGCAATTTGGGTG -> GAGGTACGCAATTTGGGTGG
CGAGTGAGCAGTTGAAAATA -> GAGTGAGCAGTTGAAAATAC
CGATAAACGCAGGATGGGAA -> GATAAACGCAGGATGGGAAT
CGATACATTAACACGGGCGG -> GATACATTAACACGGGCGGT
CGATCTCGTTAGGCGCGACA -> GATCTCGTTAGGCGCGACAG
CGATGTGGACATCTCCCCAG -> GATGTGGACATCTCCCCAGA
CGATTTACCAGCTGCGGCCG -> GATTTACCAGCTGCGGCCGG
CGCAAGATGTCCGATTTACC -> GCAAGATGTCCGATTTACCA
CGCAAGTCTAGGGCGCCCCT -> GCAAGTCTAGGGCGCCCCTG
CGCAATTTGGGTGGGCTATA -> GCAATTTGGGTGGGCTATAG
CGCAGGATGGGAATATAATT -> GCAGGATGGGAATATAATTC
CGCCACTTACTCTCGTACTA -> GCCACTTACTCTCGTACTAG
CGCCAGGTTGATTTTACCTG -> GCCAGGTTGATTTTACCTGT
CGCCCCTGTAAGGGGATAGT -> GCCCCTGTAAGGGGATAGTC
CGCCGAAAAAAGTGCTGTTC -> GCCGAAAAAAGTGCTGTTCT
CGCCTAATAAGTGAGTTAGT -> GCCTAATAAGTGAGTTAGTA
CGCGAAGCGCTCCCAGTACG -> GCGAAGCGCTCCCAGTACGC
CGCGACAGGACTTGCCGGTG -> GCGACAGGACTTGCCGGTGT
CGCGTATGTTTGAGTTGATG -> GCGTATGTTTGAGTTGATGG
CGCTATAGACTGAGGCGTCG -> GCTATAGACTGAGGCGTCGC
CGCTCCCAGTACGCTGCCCG -> GCTCCCAGTACGCTGCCCGT
CGCTGCCCGTGAGAGTGTAG -> GCTGCCCGTGAGAGTGTAGA
CGCTTGTAGGTGACATAAAT -> GCTTGTAGGTGACATAAATA
CGGAAGAGATCACACTAACA -> GGAAGAGATCACACTAACAA
CGGACAATGGCTCAATCCCA -> GGACAATGGCTCAATCCCAC
CGGACGAGTGAGCAGTTGAA -> GGACGAGTGAGCAGTTGAAA
CGGCAATTACGTGCCCTTCT -> GGCAATTACGTGCCCTTCTA
CGGCCGGACGAGTGAGCAGT -> GGCCGGACGAGTGAGCAGTT
CGGCGGCAATTACGTGCCCT -> GGCGGCAATTACGTGCCCTT
CGGGCGGTTGGAAGACAAAG -> GGGCGGTTGGAAGACAAAGT
CGGGTGAGACGCCTAATAAG -> GGGTGAGACGCCTAATAAGT
CGGTAAACGCCAGGTTGATT -> GGTAAACGCCAGGTTGATTT
CGGTGTCTGGGTTGGCCTTT -> GGTGTCTGGGTTGGCCTTTA
CGGTTGGAAGACAAAGTTGA -> GGTTGGAAGACAAAGTTGAT
CGTACTAGCCCGCGAAGCGC -> GTACTAGCCCGCGAAGCGCT
CGTATACGATACATTAACAC -> GTATACGATACATTAACACG
CGTATGTTTGAGTTGATGGA -> GTATGTTTGAGTTGATGGAC
CGTCCGTCGGTAAACGCCAG -> GTCCGTCGGTAAACGCCAGG
CGTCGCAAGTCTAGGGCGCC -> GTCGCAAGTCTAGGGCGCCC
CGTCGGTAAACGCCAGGTTG -> GTCGGTAAACGCCAGGTTGA
CGTCGTGAAACTTGTAAAGA -> GTCGTGAAACTTGTAAAGAG
CGTGAAACTTGTAAAGAGGT -> GTGAAACTTGTAAAGAGGTG
CGTGAGAGTGTAGAAATCAA -> GTGAGAGTGTAGAAATCAAG
CGTGCATATAGTGTTGATAC -> GTGCATATAGTGTTGATACA
CGTGCCCTTCTAAAAGGTCA -> GTGCCCTTCTAAAAGGTCAG
CGTGGCATACCAACTAGGTC -> GTGGCATACCAACTAGGTCT
CGTGTCTAGCGTGGCATACC -> GTGTCTAGCGTGGCATACCA
CGTTACCCGCAAGATGTCCG -> GTTACCCGCAAGATGTCCGA
CGTTAGGCGCGACAGGACTT -> GTTAGGCGCGACAGGACTTG
CGTTAGTGAATATACCCCGT -> GTTAGTGAATATACCCCGTC
CGTTTCGACGAAGTGGTATT -> GTTTCGACGAAGTGGTATTC
CTAAAAGGTCAGGAATATAT -> TAAAAGGTCAGGAATATATT
CTAACAATGCTAAGGTGCCG -> TAACAATGCTAAGGTGCCGC
CTAACTACACATGTGAGTAC -> TAACTACACATGTGAGTACC
CTAAGGTGCCGCTATAGACT -> TAAGGTGCCGCTATAGACTG
CTAATAAGTGAGTTAGTATG -> TAATAAGTGAGTTAGTATGG
CTAATATTGGGAGGCACTAA -> TAATATTGGGAGGCACTAAT
CTAATCCGACGATCTCGTTA -> TAATCCGACGATCTCGTTAG
CTAATCTCGAAATGGTAGGC -> TAATCTCGAAATGGTAGGCG
CTACACATGTGAGTACCCCG -> TACACATGTGAGTACCCCGC
CTACGCCACTTACTCTCGTA -> TACGCCACTTACTCTCGTAC
CTACGTTTCGACGAAGTGGT -> TACGTTTCGACGAAGTGGTA
CTAGCCCGCGAAGCGCTCCC -> TAGCCCGCGAAGCGCTCCCA
CTAGCGTATACGATACATTA -> TAGCGTATACGATACATTAA
CTAGCGTGGCATACCAACTA -> TAGCGTGGCATACCAACTAG
CTAGGGCGCCCCTGTAAGGG -> TAGGGCGCCCCTGTAAGGGG
CTAGGTCTAATATTGGGAGG -> TAGGTCTAATATTGGGAGGC
CTAGTACTCATATACACGCT -> TAGTACTCATATACACGCTT
CTATAGACTGAGGCGTCGCA -> TATAGACTGAGGCGTCGCAA
CTATAGGTTTGCACCCAACC -> TATAGGTTTGCACCCAACCG
CTATGACGTTACCCGCAAGA -> TATGACGTTACCCGCAAGAT
CTATGCAGTGAAACTACGCC -> TATGCAGTGAAACTACGCCA
CTATGCTGGACAGCTAACTA -> TATGCTGGACAGCTAACTAC
CTCAATCCCACGGGTGAGAC -> TCAATCCCACGGGTGAGACG
CTCACCAATCCTATGCAGTG -> TCACCAATCCTATGCAGTGA
CTCAGTCCCAAGGAAACGCC -> TCAGTCCCAAGGAAACGCCG
CTCATATACACGCTTGTAGG -> TCATATACACGCTTGTAGGT
CTCCCACACCTTATCAACAA -> TCCCACACCTTATCAACAAC
CTCCCAGTACGCTGCCCGTG -> TCCCAGTACGCTGCCCGTGA
CTCCCCAGATCACGACTCTC -> TCCCCAGATCACGACTCTCA
CTCGAAATGGTAGGCGTCCG -> TCGAAATGGTAGGCGTCCGT
CTCGTACTAGCCCGCGAAGC -> TCGTACTAGCCCGCGAAGCG
CTCGTTAGGCGCGACAGGAC -> TCGTTAGGCGCGACAGGACT
CTCTCAGTCCCAAGGAAACG -> TCTCAGTCCCAAGGAAACGC
CTCTCGTACTAGCCCGCGAA -> TCTCGTACTAGCCCGCGAAG
CTGAGGCGTCGCAAGTCTAG -> TGAGGCGTCGCAAGTCTAGG
CTGCATAGAACGAAAGGTTT -> TGCATAGAACGAAAGGTTTC
CTGCCCGTGAGAGTGTAGAA -> TGCCCGTGAGAGTGTAGAAA
CTGCGGCCGGACGAGTGAGC -> TGCGGCCGGACGAGTGAGCA
CTGGACAGCTAACTACACAT -> TGGACAGCTAACTACACATG
CTGGAGCCAGGACCCCGAGG -> TGGAGCCAGGACCCCGAGGT
CTGGGTTGGCCTTTACCCGG -> TGGGTTGGCCTTTACCCGGA
CTGTAAGGGGATAGTCAACC -> TGTAAGGGGATAGTCAACCA
CTGTTCGATAAACGCAGGAT -> TGTTCGATAAACGCAGGATG
CTGTTCTCCCACACCTTATC -> TGTTCTCCCACACCTTATCA
CTTACGGACAATGGCTCAAT -> TTACGGACAATGGCTCAATC
CTTACTCTCGTACTAGCCCG -> TTACTCTCGTACTAGCCCGC
CTTATCAACAACATTTATGG -> TTATCAACAACATTTATGGC
CTTCGGCGGCAATTACGTGC -> TTCGGCGGCAATTACGTGCC
CTTCTAAAAGGTCAGGAATA -> TTCTAAAAGGTCAGGAATAT
CTTCTATGACGTTACCCGCA -> TTCTATGACGTTACCCGCAA
CTTGCCGGTGTCTGGGTTGG -> TTGCCGGTGTCTGGGTTGGC
CTTGTAAAGAGGTGGAACTA -> TTGTAAAGAGGTGGAACTAT
CTTGTAGGTGACATAAATAG -> TTGTAGGTGACATAAATAGC
CTTGTGCTACGTTTCGACGA -> TTGTGCTACGTTTCGACGAA
CTTTACCCGGAAGAGATCAC -> TTTACCCGGAAGAGATCACA
GAAAAAAGTGCTGTTCTCCC -> AAAAAAGTGCTGTTCTCCCA
GAAAATACGAGGCGAAGCTG -> AAAATACGAGGCGAAGCTGC
GAAACGCCGAAAAAAGTGCT -> AAACGCCGAAAAAAGTGCTG
GAAACTACGCCACTTACTCT -> AAACTACGCCACTTACTCTC
GAAACTTGTAAAGAGGTGGA -> AAACTTGTAAAGAGGTGGAA
GAAAGGTTTCTTACGGACAA -> AAAGGTTTCTTACGGACAAT
GAAATCAAGTGAACCACGAT -> AAATCAAGTGAACCACGATG
GAAATGGTAGGCGTCCGTCG -> AAATGGTAGGCGTCCGTCGG
GAACCACGATGTGGACATCT -> AACCACGATGTGGACATCTC
GAACGAAAGGTTTCTTACGG -> AACGAAAGGTTTCTTACGGA
GAACTATGCTGGACAGCTAA -> AACTATGCTGGACAGCTAAC
GAAGACAAAGTTGATGCCCC -> AAGACAAAGTTGATGCCCCA
GAAGAGATCACACTAACAAT -> AAGAGATCACACTAACAATG
GAAGCGCTCCCAGTACGCTG -> AAGCGCTCCCAGTACGCTGC
GAAGTGGTATTCTTCGGCGG -> AAGTGGTATTCTTCGGCGGC
GAATATAATTCTAGCGTATA -> AATATAATTCTAGCGTATAC
GAATATACCCCGTCGTGAAA -> AATATACCCCGTCGTGAAAC
GAATATATTCTAATCTCGAA -> AATATATTCTAATCTCGAAA
GACAAAGTTGATGCCCCACT -> ACAAAGTTGATGCCCCACTA
GACAATGGCTCAATCCCACG -> ACAATGGCTCAATCCCACGG
GACAGCTAACTACACATGTG -> ACAGCTAACTACACATGTGA
GACAGGACTTGCCGGTGTCT -> ACAGGACTTGCCGGTGTCTG
GACATAAATAGCACTTCTAT -> ACATAAATAGCACTTCTATG
GACATCTCCCCAGATCACGA -> ACATCTCCCCAGATCACGAC
GACATTAGTATACCTCACCA -> ACATTAGTATACCTCACCAA
GACCCCGAGGTACGCAATTT -> ACCCCGAGGTACGCAATTTG
GACGAAGTGGTATTCTTCGG -> ACGAAGTGGTATTCTTCGGC
GACGAGTGAGCAGTTGAAAA -> ACGAGTGAGCAGTTGAAAAT
GACGATCTCGTTAGGCGCGA -> ACGATCTCGTTAGGCGCGAC
GACGCCTAATAAGTGAGTTA -> ACGCCTAATAAGTGAGTTAG
GACGTTACCCGCAAGATGTC -> ACGTTACCCGCAAGATGTCC
GACTCTCAGTCCCAAGGAAA -> ACTCTCAGTCCCAAGGAAAC
GACTGAGGCGTCGCAAGTCT -> ACTGAGGCGTCGCAAGTCTA
GACTTGCCGGTGTCTGGGTT -> ACTTGCCGGTGTCTGGGTTG
GAGACGCCTAATAAGTGAGT -> AGACGCCTAATAAGTGAGTT
GAGAGTGTAGAAATCAAGTG -> AGAGTGTAGAAATCAAGTGA
GAGATCACACTAACAATGCT -> AGATCACACTAACAATGCTA
GAGCAGTTGAAAATACGAGG -> AGCAGTTGAAAATACGAGGC
GAGCCAGGACCCCGAGGTAC -> AGCCAGGACCCCGAGGTACG
GAGGCACTAATCCGACGATC -> AGGCACTAATCCGACGATCT
GAGGCGTCGCAAGTCTAGGG -> AGGCGTCGCAAGTCTAGGGC
GAGGTACGCAATTTGGGTGG -> AGGTACGCAATTTGGGTGGG
GAGGTGGAACTATGCTGGAC -> AGGTGGAACTATGCTGGACA
GAGTACCCCGCGTATGTTTG -> AGTACCCCGCGTATGTTTGA
GAGTGAGCAGTTGAAAATAC -> AGTGAGCAGTTGAAAATACG
GAGTGTAGAAATCAAGTGAA -> AGTGTAGAAATCAAGTGAAC
GAGTTAGTATGGCGTGCATA -> AGTTAGTATGGCGTGCATAT
GAGTTGATGGACATTAGTAT -> AGTTGATGGACATTAGTATA
GATAAACGCAGGATGGGAAT -> ATAAACGCAGGATGGGAATA
GATACACTGGAGCCAGGACC -> ATACACTGGAGCCAGGACCC
GATACATTAACACGGGCGGT -> ATACATTAACACGGGCGGTT
GATAGTCAACCAATGTGTCT -> ATAGTCAACCAATGTGTCTT
GATCACACTAACAATGCTAA -> ATCACACTAACAATGCTAAG
GATCACGACTCTCAGTCCCA -> ATCACGACTCTCAGTCCCAA
GATCTCGTTAGGCGCGACAG -> ATCTCGTTAGGCGCGACAGG
GATGCCCCACTAGTACTCAT -> ATGCCCCACTAGTACTCATA
GATGGACATTAGTATACCTC -> ATGGACATTAGTATACCTCA
GATGGGAATATAATTCTAGC -> ATGGGAATATAATTCTAGCG
GATGTCCGATTTACCAGCTG -> ATGTCCGATTTACCAGCTGC
GATGTGGACATCTCCCCAGA -> ATGTGGACATCTCCCCAGAT
GATTTACCAGCTGCGGCCGG -> ATTTACCAGCTGCGGCCGGA
GATTTTACCTGTTCGATAAA -> ATTTTACCTGTTCGATAAAC
GCAAGATGTCCGATTTACCA -> CAAGATGTCCGATTTACCAG
GCAAGTCTAGGGCGCCCCTG -> CAAGTCTAGGGCGCCCCTGT
GCAATTACGTGCCCTTCTAA -> CAATTACGTGCCCTTCTAAA
GCAATTTGGGTGGGCTATAG -> CAATTTGGGTGGGCTATAGG
GCACCCAACCGTGTCTAGCG -> CACCCAACCGTGTCTAGCGT
GCACTAATCCGACGATCTCG -> CACTAATCCGACGATCTCGT
GCACTTCTATGACGTTACCC -> CACTTCTATGACGTTACCCG
GCAGGATGGGAATATAATTC -> CAGGATGGGAATATAATTCT
GCAGTGAAACTACGCCACTT -> CAGTGAAACTACGCCACTTA
GCAGTTGAAAATACGAGGCG -> CAGTTGAAAATACGAGGCGA
GCATACCAACTAGGTCTAAT -> CATACCAACTAGGTCTAATA
GCATAGAACGAAAGGTTTCT -> CATAGAACGAAAGGTTTCTT
GCATATAGTGTTGATACACT -> CATATAGTGTTGATACACTG
GCCACTTACTCTCGTACTAG -> CCACTTACTCTCGTACTAGC
GCCAGGACCCCGAGGTACGC -> CCAGGACCCCGAGGTACGCA
GCCAGGTTGATTTTACCTGT -> CCAGGTTGATTTTACCTGTT
GCCCCACTAGTACTCATATA -> CCCCACTAGTACTCATATAC
GCCCCTGTAAGGGGATAGTC -> CCCCTGTAAGGGGATAGTCA
GCCCGCGAAGCGCTCCCAGT -> CCCGCGAAGCGCTCCCAGTA
GCCCGTGAGAGTGTAGAAAT -> CCCGTGAGAGTGTAGAAATC
GCCCTTCTAAAAGGTCAGGA -> CCCTTCTAAAAGGTCAGGAA
GCCGAAAAAAGTGCTGTTCT -> CCGAAAAAAGTGCTGTTCTC
GCCGCTATAGACTGAGGCGT -> CCGCTATAGACTGAGGCGTC
GCCGGACGAGTGAGCAGTTG -> CCGGACGAGTGAGCAGTTGA
GCCGGTGTCTGGGTTGGCCT -> CCGGTGTCTGGGTTGGCCTT
GCCTAATAAGTGAGTTAGTA -> CCTAATAAGTGAGTTAGTAT
GCCTTTACCCGGAAGAGATC -> CCTTTACCCGGAAGAGATCA
GCGAAGCGCTCCCAGTACGC -> CGAAGCGCTCCCAGTACGCT
GCGACAGGACTTGCCGGTGT -> CGACAGGACTTGCCGGTGTC
GCGCCCCTGTAAGGGGATAG -> CGCCCCTGTAAGGGGATAGT
GCGCGACAGGACTTGCCGGT -> CGCGACAGGACTTGCCGGTG
GCGCTCCCAGTACGCTGCCC -> CGCTCCCAGTACGCTGCCCG
GCGGCAATTACGTGCCCTTC -> CGGCAATTACGTGCCCTTCT
GCGGCCGGACGAGTGAGCAG -> CGGCCGGACGAGTGAGCAGT
GCGGTTGGAAGACAAAGTTG -> CGGTTGGAAGACAAAGTTGA
GCGTATACGATACATTAACA -> CGTATACGATACATTAACAC
GCGTATGTTTGAGTTGATGG -> CGTATGTTTGAGTTGATGGA
GCGTCCGTCGGTAAACGCCA -> CGTCCGTCGGTAAACGCCAG
GCGTCGCAAGTCTAGGGCGC -> CGTCGCAAGTCTAGGGCGCC
GCGTGCATATAGTGTTGATA -> CGTGCATATAGTGTTGATAC
GCGTGGCATACCAACTAGGT -> CGTGGCATACCAACTAGGTC
GCTAACTACACATGTGAGTA -> CTAACTACACATGTGAGTAC
GCTAAGGTGCCGCTATAGAC -> CTAAGGTGCCGCTATAGACT
GCTACGTTTCGACGAAGTGG -> CTACGTTTCGACGAAGTGGT
GCTATAGACTGAGGCGTCGC -> CTATAGACTGAGGCGTCGCA
GCTATAGGTTTGCACCCAAC -> CTATAGGTTTGCACCCAACC
GCTCAATCCCACGGGTGAGA -> CTCAATCCCACGGGTGAGAC
GCTCCCAGTACGCTGCCCGT -> CTCCCAGTACGCTGCCCGTG
GCTGCATAGAACGAAAGGTT -> CTGCATAGAACGAAAGGTTT
GCTGCCCGTGAGAGTGTAGA -> CTGCCCGTGAGAGTGTAGAA
GCTGCGGCCGGACGAGTGAG -> CTGCGGCCGGACGAGTGAGC
GCTGGACAGCTAACTACACA -> CTGGACAGCTAACTACACAT
GCTGTTCTCCCACACCTTAT -> CTGTTCTCCCACACCTTATC
GCTTGTAGGTGACATAAATA -> CTTGTAGGTGACATAAATAG
GGAAACGCCGAAAAAAGTGC -> GAAACGCCGAAAAAAGTGCT
GGAACTATGCTGGACAGCTA -> GAACTATGCTGGACAGCTAA
GGAAGACAAAGTTGATGCCC -> GAAGACAAAGTTGATGCCCC
GGAAGAGATCACACTAACAA -> GAAGAGATCACACTAACAAT
GGAATATAATTCTAGCGTAT -> GAATATAATTCTAGCGTATA
GGAATATATTCTAATCTCGA -> GAATATATTCTAATCTCGAA
GGACAATGGCTCAATCCCAC -> GACAATGGCTCAATCCCACG
GGACAGCTAACTACACATGT -> GACAGCTAACTACACATGTG
GGACATCTCCCCAGATCACG -> GACATCTCCCCAGATCACGA
GGACATTAGTATACCTCACC -> GACATTAGTATACCTCACCA
GGACCCCGAGGTACGCAATT -> GACCCCGAGGTACGCAATTT
GGACGAGTGAGCAGTTGAAA -> GACGAGTGAGCAGTTGAAAA
GGACTTGCCGGTGTCTGGGT -> GACTTGCCGGTGTCTGGGTT
GGAGCCAGGACCCCGAGGTA -> GAGCCAGGACCCCGAGGTAC
GGAGGCACTAATCCGACGAT -> GAGGCACTAATCCGACGATC
GGATAGTCAACCAATGTGTC -> GATAGTCAACCAATGTGTCT
GGATGGGAATATAATTCTAG -> GATGGGAATATAATTCTAGC
GGCAATTACGTGCCCTTCTA -> GCAATTACGTGCCCTTCTAA
GGCACTAATCCGACGATCTC -> GCACTAATCCGACGATCTCG
GGCATACCAACTAGGTCTAA -> GCATACCAACTAGGTCTAAT
GGCCGGACGAGTGAGCAGTT -> GCCGGACGAGTGAGCAGTTG
GGCCTTTACCCGGAAGAGAT -> GCCTTTACCCGGAAGAGATC
GGCGCCCCTGTAAGGGGATA -> GCGCCCCTGTAAGGGGATAG
GGCGCGACAGGACTTGCCGG -> GCGCGACAGGACTTGCCGGT
GGCGGCAATTACGTGCCCTT -> GCGGCAATTACGTGCCCTTC
GGCGGTTGGAAGACAAAGTT -> GCGGTTGGAAGACAAAGTTG
GGCGTCCGTCGGTAAACGCC -> GCGTCCGTCGGTAAACGCCA
GGCGTCGCAAGTCTAGGGCG -> GCGTCGCAAGTCTAGGGCGC
GGCGTGCATATAGTGTTGAT -> GCGTGCATATAGTGTTGATA
GGCTATAGGTTTGCACCCAA -> GCTATAGGTTTGCACCCAAC
GGCTCAATCCCACGGGTGAG -> GCTCAATCCCACGGGTGAGA
GGCTGCATAGAACGAAAGGT -> GCTGCATAGAACGAAAGGTT
GGGAATATAATTCTAGCGTA -> GGAATATAATTCTAGCGTAT
GGGAGGCACTAATCCGACGA -> GGAGGCACTAATCCGACGAT
GGGATAGTCAACCAATGTGT -> GGATAGTCAACCAATGTGTC
GGGCGCCCCTGTAAGGGGAT -> GGCGCCCCTGTAAGGGGATA
GGGCGGTTGGAAGACAAAGT -> GGCGGTTGGAAGACAAAGTT
GGGCTATAGGTTTGCACCCA -> GGCTATAGGTTTGCACCCAA
GGGGATAGTCAACCAATGTG -> GGGATAGTCAACCAATGTGT
GGGTGAGACGCCTAATAAGT -> GGTGAGACGCCTAATAAGTG
GGGTGGGCTATAGGTTTGCA -> GGTGGGCTATAGGTTTGCAC
GGGTTGGCCTTTACCCGGAA -> GGTTGGCCTTTACCCGGAAG
GGTAAACGCCAGGTTGATTT -> GTAAACGCCAGGTTGATTTT
GGTACGCAATTTGGGTGGGC -> GTACGCAATTTGGGTGGGCT
GGTAGGCGTCCGTCGGTAAA -> GTAGGCGTCCGTCGGTAAAC
GGTATTCTTCGGCGGCAATT -> GTATTCTTCGGCGGCAATTA
GGTCAGGAATATATTCTAAT -> GTCAGGAATATATTCTAATC
GGTCTAATATTGGGAGGCAC -> GTCTAATATTGGGAGGCACT
GGTGACATAAATAGCACTTC -> GTGACATAAATAGCACTTCT
GGTGAGACGCCTAATAAGTG -> GTGAGACGCCTAATAAGTGA
GGTGCCGCTATAGACTGAGG -> GTGCCGCTATAGACTGAGGC
GGTGGAACTATGCTGGACAG -> GTGGAACTATGCTGGACAGC
GGTGGGCTATAGGTTTGCAC -> GTGGGCTATAGGTTTGCACC
GGTGTCTGGGTTGGCCTTTA -> GTGTCTGGGTTGGCCTTTAC
GGTTGATTTTACCTGTTCGA -> GTTGATTTTACCTGTTCGAT
GGTTGGAAGACAAAGTTGAT -> GTTGGAAGACAAAGTTGATG
GGTTGGCCTTTACCCGGAAG -> GTTGGCCTTTACCCGGAAGA
GGTTTCTTACGGACAATGGC -> GTTTCTTACGGACAATGGCT
GGTTTGCACCCAACCGTGTC -> GTTTGCACCCAACCGTGTCT
GTAAACGCCAGGTTGATTTT -> TAAACGCCAGGTTGATTTTA
GTAAAGAGGTGGAACTATGC -> TAAAGAGGTGGAACTATGCT
GTAACCGTTAGTGAATATAC -> TAACCGTTAGTGAATATACC
GTAAGGGGATAGTCAACCAA -> TAAGGGGATAGTCAACCAAT
GTACCCCGCGTATGTTTGAG -> TACCCCGCGTATGTTTGAGT
GTACGCAATTTGGGTGGGCT -> TACGCAATTTGGGTGGGCTA
GTACGCTGCCCGTGAGAGTG -> TACGCTGCCCGTGAGAGTGT
GTACTAGCCCGCGAAGCGCT -> TACTAGCCCGCGAAGCGCTC
GTACTCATATACACGCTTGT -> TACTCATATACACGCTTGTA
GTAGAAATCAAGTGAACCAC -> TAGAAATCAAGTGAACCACG
GTAGGCGTCCGTCGGTAAAC -> TAGGCGTCCGTCGGTAAACG
GTAGGTGACATAAATAGCAC -> TAGGTGACATAAATAGCACT
GTATACCTCACCAATCCTAT -> TATACCTCACCAATCCTATG
GTATACGATACATTAACACG -> TATACGATACATTAACACGG
GTATGGCGTGCATATAGTGT -> TATGGCGTGCATATAGTGTT
GTATGTTTGAGTTGATGGAC -> TATGTTTGAGTTGATGGACA
GTATTCTTCGGCGGCAATTA -> TATTCTTCGGCGGCAATTAC
GTCAACCAATGTGTCTTGTG -> TCAACCAATGTGTCTTGTGC
GTCAGGAATATATTCTAATC -> TCAGGAATATATTCTAATCT
GTCCCAAGGAAACGCCGAAA -> TCCCAAGGAAACGCCGAAAA
GTCCGATTTACCAGCTGCGG -> TCCGATTTACCAGCTGCGGC
GTCCGTCGGTAAACGCCAGG -> TCCGTCGGTAAACGCCAGGT
GTCGCAAGTCTAGGGCGCCC -> TCGCAAGTCTAGGGCGCCCC
GTCGGTAAACGCCAGGTTGA -> TCGGTAAACGCCAGGTTGAT
GTCGTGAAACTTGTAAAGAG -> TCGTGAAACTTGTAAAGAGG
GTCTAATATTGGGAGGCACT -> TCTAATATTGGGAGGCACTA
GTCTAGCGTGGCATACCAAC -> TCTAGCGTGGCATACCAACT
GTCTAGGGCGCCCCTGTAAG -> TCTAGGGCGCCCCTGTAAGG
GTCTGGGTTGGCCTTTACCC -> TCTGGGTTGGCCTTTACCCG
GTCTTGTGCTACGTTTCGAC -> TCTTGTGCTACGTTTCGACG
GTGAAACTACGCCACTTACT -> TGAAACTACGCCACTTACTC
GTGAAACTTGTAAAGAGGTG -> TGAAACTTGTAAAGAGGTGG
GTGAACCACGATGTGGACAT -> TGAACCACGATGTGGACATC
GTGAATATACCCCGTCGTGA -> TGAATATACCCCGTCGTGAA
GTGACATAAATAGCACTTCT -> TGACATAAATAGCACTTCTA
GTGAGACGCCTAATAAGTGA -> TGAGACGCCTAATAAGTGAG
GTGAGAGTGTAGAAATCAAG -> TGAGAGTGTAGAAATCAAGT
GTGAGCAGTTGAAAATACGA -> TGAGCAGTTGAAAATACGAG
GTGAGTACCCCGCGTATGTT -> TGAGTACCCCGCGTATGTTT
GTGAGTTAGTATGGCGTGCA -> TGAGTTAGTATGGCGTGCAT
GTGCATATAGTGTTGATACA -> TGCATATAGTGTTGATACAC
GTGCCCTTCTAAAAGGTCAG -> TGCCCTTCTAAAAGGTCAGG
GTGCCGCTATAGACTGAGGC -> TGCCGCTATAGACTGAGGCG
GTGCTACGTTTCGACGAAGT -> TGCTACGTTTCGACGAAGTG
GTGCTGTTCTCCCACACCTT -> TGCTGTTCTCCCACACCTTA
GTGGAACTATGCTGGACAGC -> TGGAACTATGCTGGACAGCT
GTGGACATCTCCCCAGATCA -> TGGACATCTCCCCAGATCAC
GTGGCATACCAACTAGGTCT -> TGGCATACCAACTAGGTCTA
GTGGGCTATAGGTTTGCACC -> TGGGCTATAGGTTTGCACCC
GTGGTATTCTTCGGCGGCAA -> TGGTATTCTTCGGCGGCAAT
GTGTAGAAATCAAGTGAACC -> TGTAGAAATCAAGTGAACCA
GTGTCTAGCGTGGCATACCA -> TGTCTAGCGTGGCATACCAA
GTGTCTGGGTTGGCCTTTAC -> TGTCTGGGTTGGCCTTTACC
GTGTCTTGTGCTACGTTTCG -> TGTCTTGTGCTACGTTTCGA
GTGTTGATACACTGGAGCCA -> TGTTGATACACTGGAGCCAG
GTTACCCGCAAGATGTCCGA -> TTACCCGCAAGATGTCCGAT
GTTAGGCGCGACAGGACTTG -> TTAGGCGCGACAGGACTTGC
GTTAGTATGGCGTGCATATA -> TTAGTATGGCGTGCATATAG
GTTAGTGAATATACCCCGTC -> TTAGTGAATATACCCCGTCG
GTTCGATAAACGCAGGATGG -> TTCGATAAACGCAGGATGGG
GTTCTCCCACACCTTATCAA -> TTCTCCCACACCTTATCAAC
GTTGAAAATACGAGGCGAAG -> TTGAAAATACGAGGCGAAGC
GTTGATACACTGGAGCCAGG -> TTGATACACTGGAGCCAGGA
GTTGATGCCCCACTAGTACT -> TTGATGCCCCACTAGTACTC
GTTGATGGACATTAGTATAC -> TTGATGGACATTAGTATACC
GTTGATTTTACCTGTTCGAT -> TTGATTTTACCTGTTCGATA
GTTGGAAGACAAAGTTGATG -> TTGGAAGACAAAGTTGATGC
GTTGGCCTTTACCCGGAAGA -> TTGGCCTTTACCCGGAAGAG
GTTTCGACGAAGTGGTATTC -> TTTCGACGAAGTGGTATTCT
GTTTCTTACGGACAATGGCT -> TTTCTTACGGACAATGGCTC
GTTTGAGTTGATGGACATTA -> TTTGAGTTGATGGACATTAG
GTTTGCACCCAACCGTGTCT -> TTTGCACCCAACCGTGTCTA
TAAAAGGTCAGGAATATATT -> AAAAGGTCAGGAATATATTC
TAAACGCAGGATGGGAATAT -> AAACGCAGGATGGGAATATA
TAAACGCCAGGTTGATTTTA -> AAACGCCAGGTTGATTTTAC
TAAAGAGGTGGAACTATGCT -> AAAGAGGTGGAACTATGCTG
TAAATAGCACTTCTATGACG -> AAATAGCACTTCTATGACGT
TAACAATGCTAAGGTGCCGC -> AACAATGCTAAGGTGCCGCT
TAACACGGGCGGTTGGAAGA -> AACACGGGCGGTTGGAAGAC
TAACCGTTAGTGAATATACC -> AACCGTTAGTGAATATACCC
TAACTACACATGTGAGTACC -> AACTACACATGTGAGTACCC
TAAGGGGATAGTCAACCAAT -> AAGGGGATAGTCAACCAATG
TAAGGTGCCGCTATAGACTG -> AAGGTGCCGCTATAGACTGA
TAAGTGAGTTAGTATGGCGT -> AAGTGAGTTAGTATGGCGTG
TAATAAGTGAGTTAGTATGG -> AATAAGTGAGTTAGTATGGC
TAATATTGGGAGGCACTAAT -> AATATTGGGAGGCACTAATC
TAATCCGACGATCTCGTTAG -> AATCCGACGATCTCGTTAGG
TAATCTCGAAATGGTAGGCG -> AATCTCGAAATGGTAGGCGT
TAATTCTAGCGTATACGATA -> AATTCTAGCGTATACGATAC
TACACATGTGAGTACCCCGC -> ACACATGTGAGTACCCCGCG
TACACGCTTGTAGGTGACAT -> ACACGCTTGTAGGTGACATA
TACACTGGAGCCAGGACCCC -> ACACTGGAGCCAGGACCCCG
TACATTAACACGGGCGGTTG -> ACATTAACACGGGCGGTTGG
TACCAACTAGGTCTAATATT -> ACCAACTAGGTCTAATATTG
TACCAGCTGCGGCCGGACGA -> ACCAGCTGCGGCCGGACGAG
TACCCCGCGTATGTTTGAGT -> ACCCCGCGTATGTTTGAGTT
TACCCCGTCGTGAAACTTGT -> ACCCCGTCGTGAAACTTGTA
TACCCGCAAGATGTCCGATT -> ACCCGCAAGATGTCCGATTT
TACCCGGAAGAGATCACACT -> ACCCGGAAGAGATCACACTA
TACCTCACCAATCCTATGCA -> ACCTCACCAATCCTATGCAG
TACCTGTTCGATAAACGCAG -> ACCTGTTCGATAAACGCAGG
TACGATACATTAACACGGGC -> ACGATACATTAACACGGGCG
TACGCAATTTGGGTGGGCTA -> ACGCAATTTGGGTGGGCTAT
TACGCCACTTACTCTCGTAC -> ACGCCACTTACTCTCGTACT
TACGCTGCCCGTGAGAGTGT -> ACGCTGCCCGTGAGAGTGTA
TACGGACAATGGCTCAATCC -> ACGGACAATGGCTCAATCCC
TACGTGCCCTTCTAAAAGGT -> ACGTGCCCTTCTAAAAGGTC
TACGTTTCGACGAAGTGGTA -> ACGTTTCGACGAAGTGGTAT
TACTAGCCCGCGAAGCGCTC -> ACTAGCCCGCGAAGCGCTCC
TACTCATATACACGCTTGTA -> ACTCATATACACGCTTGTAG
TACTCTCGTACTAGCCCGCG -> ACTCTCGTACTAGCCCGCGA
TAGAAATCAAGTGAACCACG -> AGAAATCAAGTGAACCACGA
TAGAACGAAAGGTTTCTTAC -> AGAACGAAAGGTTTCTTACG
TAGACTGAGGCGTCGCAAGT -> AGACTGAGGCGTCGCAAGTC
TAGCACTTCTATGACGTTAC -> AGCACTTCTATGACGTTACC
TAGCCCGCGAAGCGCTCCCA -> AGCCCGCGAAGCGCTCCCAG
TAGCGTATACGATACATTAA -> AGCGTATACGATACATTAAC
TAGCGTGGCATACCAACTAG -> AGCGTGGCATACCAACTAGG
TAGGCGCGACAGGACTTGCC -> AGGCGCGACAGGACTTGCCG
TAGGCGTCCGTCGGTAAACG -> AGGCGTCCGTCGGTAAACGC
TAGGGCGCCCCTGTAAGGGG -> AGGGCGCCCCTGTAAGGGGA
TAGGTCTAATATTGGGAGGC -> AGGTCTAATATTGGGAGGCA
TAGGTGACATAAATAGCACT -> AGGTGACATAAATAGCACTT
TAGGTTTGCACCCAACCGTG -> AGGTTTGCACCCAACCGTGT
TAGTACTCATATACACGCTT -> AGTACTCATATACACGCTTG
TAGTATACCTCACCAATCCT -> AGTATACCTCACCAATCCTA
TAGTATGGCGTGCATATAGT -> AGTATGGCGTGCATATAGTG
TAGTCAACCAATGTGTCTTG -> AGTCAACCAATGTGTCTTGT
TAGTGAATATACCCCGTCGT -> AGTGAATATACCCCGTCGTG
TAGTGTTGATACACTGGAGC -> AGTGTTGATACACTGGAGCC
TATAATTCTAGCGTATACGA -> ATAATTCTAGCGTATACGAT
TATACACGCTTGTAGGTGAC -> ATACACGCTTGTAGGTGACA
TATACCCCGTCGTGAAACTT -> ATACCCCGTCGTGAAACTTG
TATACCTCACCAATCCTATG -> ATACCTCACCAATCCTATGC
TATACGATACATTAACACGG -> ATACGATACATTAACACGGG
TATAGACTGAGGCGTCGCAA -> ATAGACTGAGGCGTCGCAAG
TATAGGTTTGCACCCAACCG -> ATAGGTTTGCACCCAACCGT
TATAGTGTTGATACACTGGA -> ATAGTGTTGATACACTGGAG
TATATTCTAATCTCGAAATG -> ATATTCTAATCTCGAAATGG
TATCAACAACATTTATGGCT -> ATCAACAACATTTATGGCTG
TATGACGTTACCCGCAAGAT -> ATGACGTTACCCGCAAGATG
TATGCAGTGAAACTACGCCA -> ATGCAGTGAAACTACGCCAC
TATGCTGGACAGCTAACTAC -> ATGCTGGACAGCTAACTACA
TATGGCGTGCATATAGTGTT -> ATGGCGTGCATATAGTGTTG
TATGGCTGCATAGAACGAAA -> ATGGCTGCATAGAACGAAAG
TATGTTTGAGTTGATGGACA -> ATGTTTGAGTTGATGGACAT
TATTCTAATCTCGAAATGGT -> ATTCTAATCTCGAAATGGTA
TATTCTTCGGCGGCAATTAC -> ATTCTTCGGCGGCAATTACG
TATTGGGAGGCACTAATCCG -> ATTGGGAGGCACTAATCCGA
TCAACAACATTTATGGCTGC -> CAACAACATTTATGGCTGCA
TCAACCAATGTGTCTTGTGC -> CAACCAATGTGTCTTGTGCT
TCAAGTGAACCACGATGTGG -> CAAGTGAACCACGATGTGGA
TCAATCCCACGGGTGAGACG -> CAATCCCACGGGTGAGACGC
TCACACTAACAATGCTAAGG -> CACACTAACAATGCTAAGGT
TCACCAATCCTATGCAGTGA -> CACCAATCCTATGCAGTGAA
TCACGACTCTCAGTCCCAAG -> CACGACTCTCAGTCCCAAGG
TCAGGAATATATTCTAATCT -> CAGGAATATATTCTAATCTC
TCAGTCCCAAGGAAACGCCG -> CAGTCCCAAGGAAACGCCGA
TCATATACACGCTTGTAGGT -> CATATACACGCTTGTAGGTG
TCCCAAGGAAACGCCGAAAA -> CCCAAGGAAACGCCGAAAAA
TCCCACACCTTATCAACAAC -> CCCACACCTTATCAACAACA
TCCCACGGGTGAGACGCCTA -> CCCACGGGTGAGACGCCTAA
TCCCAGTACGCTGCCCGTGA -> CCCAGTACGCTGCCCGTGAG
TCCCCAGATCACGACTCTCA -> CCCCAGATCACGACTCTCAG
TCCGACGATCTCGTTAGGCG -> CCGACGATCTCGTTAGGCGC
TCCGATTTACCAGCTGCGGC -> CCGATTTACCAGCTGCGGCC
TCCGTCGGTAAACGCCAGGT -> CCGTCGGTAAACGCCAGGTT
TCCTATGCAGTGAAACTACG -> CCTATGCAGTGAAACTACGC
TCGAAATGGTAGGCGTCCGT -> CGAAATGGTAGGCGTCCGTC
TCGACGAAGTGGTATTCTTC -> CGACGAAGTGGTATTCTTCG
TCGATAAACGCAGGATGGGA -> CGATAAACGCAGGATGGGAA
TCGCAAGTCTAGGGCGCCCC -> CGCAAGTCTAGGGCGCCCCT
TCGGCGGCAATTACGTGCCC -> CGGCGGCAATTACGTGCCCT
TCGGTAAACGCCAGGTTGAT -> CGGTAAACGCCAGGTTGATT
TCGTACTAGCCCGCGAAGCG -> CGTACTAGCCCGCGAAGCGC
TCGTGAAACTTGTAAAGAGG -> CGTGAAACTTGTAAAGAGGT
TCGTTAGGCGCGACAGGACT -> CGTTAGGCGCGACAGGACTT
TCTAAAAGGTCAGGAATATA -> CTAAAAGGTCAGGAATATAT
TCTAATATTGGGAGGCACTA -> CTAATATTGGGAGGCACTAA
TCTAATCTCGAAATGGTAGG -> CTAATCTCGAAATGGTAGGC
TCTAGCGTATACGATACATT -> CTAGCGTATACGATACATTA
TCTAGCGTGGCATACCAACT -> CTAGCGTGGCATACCAACTA
TCTAGGGCGCCCCTGTAAGG -> CTAGGGCGCCCCTGTAAGGG
TCTATGACGTTACCCGCAAG -> CTATGACGTTACCCGCAAGA
TCTCAGTCCCAAGGAAACGC -> CTCAGTCCCAAGGAAACGCC
TCTCCCACACCTTATCAACA -> CTCCCACACCTTATCAACAA
TCTCCCCAGATCACGACTCT -> CTCCCCAGATCACGACTCTC
TCTCGAAATGGTAGGCGTCC -> CTCGAAATGGTAGGCGTCCG
TCTCGTACTAGCCCGCGAAG -> CTCGTACTAGCCCGCGAAGC
TCTCGTTAGGCGCGACAGGA -> CTCGTTAGGCGCGACAGGAC
TCTGGGTTGGCCTTTACCCG -> CTGGGTTGGCCTTTACCCGG
TCTTACGGACAATGGCTCAA -> CTTACGGACAATGGCTCAAT
TCTTCGGCGGCAATTACGTG -> CTTCGGCGGCAATTACGTGC
TCTTGTGCTACGTTTCGACG -> CTTGTGCTACGTTTCGACGA
TGAAAATACGAGGCGAAGCT -> GAAAATACGAGGCGAAGCTG
TGAAACTACGCCACTTACTC -> GAAACTACGCCACTTACTCT
TGAAACTTGTAAAGAGGTGG -> GAAACTTGTAAAGAGGTGGA
TGAACCACGATGTGGACATC -> GAACCACGATGTGGACATCT
TGAATATACCCCGTCGTGAA -> GAATATACCCCGTCGTGAAA
TGACATAAATAGCACTTCTA -> GACATAAATAGCACTTCTAT
TGACGTTACCCGCAAGATGT -> GACGTTACCCGCAAGATGTC
TGAGACGCCTAATAAGTGAG -> GAGACGCCTAATAAGTGAGT
TGAGAGTGTAGAAATCAAGT -> GAGAGTGTAGAAATCAAGTG
TGAGCAGTTGAAAATACGAG -> GAGCAGTTGAAAATACGAGG
TGAGGCGTCGCAAGTCTAGG -> GAGGCGTCGCAAGTCTAGGG
TGAGTACCCCGCGTATGTTT -> GAGTACCCCGCGTATGTTTG
TGAGTTAGTATGGCGTGCAT -> GAGTTAGTATGGCGTGCATA
TGAGTTGATGGACATTAGTA -> GAGTTGATGGACATTAGTAT
TGATACACTGGAGCCAGGAC -> GATACACTGGAGCCAGGACC
TGATGCCCCACTAGTACTCA -> GATGCCCCACTAGTACTCAT
TGATGGACATTAGTATACCT -> GATGGACATTAGTATACCTC
TGATTTTACCTGTTCGATAA -> GATTTTACCTGTTCGATAAA
TGCACCCAACCGTGTCTAGC -> GCACCCAACCGTGTCTAGCG
TGCAGTGAAACTACGCCACT -> GCAGTGAAACTACGCCACTT
TGCATAGAACGAAAGGTTTC -> GCATAGAACGAAAGGTTTCT
TGCATATAGTGTTGATACAC -> GCATATAGTGTTGATACACT
TGCCCCACTAGTACTCATAT -> GCCCCACTAGTACTCATATA
TGCCCGTGAGAGTGTAGAAA -> GCCCGTGAGAGTGTAGAAAT
TGCCCTTCTAAAAGGTCAGG -> GCCCTTCTAAAAGGTCAGGA
TGCCGCTATAGACTGAGGCG -> GCCGCTATAGACTGAGGCGT
TGCCGGTGTCTGGGTTGGCC -> GCCGGTGTCTGGGTTGGCCT
TGCGGCCGGACGAGTGAGCA -> GCGGCCGGACGAGTGAGCAG
TGCTAAGGTGCCGCTATAGA -> GCTAAGGTGCCGCTATAGAC
TGCTACGTTTCGACGAAGTG -> GCTACGTTTCGACGAAGTGG
TGCTGGACAGCTAACTACAC -> GCTGGACAGCTAACTACACA
TGCTGTTCTCCCACACCTTA -> GCTGTTCTCCCACACCTTAT
TGGAACTATGCTGGACAGCT -> GGAACTATGCTGGACAGCTA
TGGAAGACAAAGTTGATGCC -> GGAAGACAAAGTTGATGCCC
TGGACAGCTAACTACACATG -> GGACAGCTAACTACACATGT
TGGACATCTCCCCAGATCAC -> GGACATCTCCCCAGATCACG
TGGACATTAGTATACCTCAC -> GGACATTAGTATACCTCACC
TGGAGCCAGGACCCCGAGGT -> GGAGCCAGGACCCCGAGGTA
TGGCATACCAACTAGGTCTA -> GGCATACCAACTAGGTCTAA
TGGCCTTTACCCGGAAGAGA -> GGCCTTTACCCGGAAGAGAT
TGGCGTGCATATAGTGTTGA -> GGCGTGCATATAGTGTTGAT
TGGCTCAATCCCACGGGTGA -> GGCTCAATCCCACGGGTGAG
TGGCTGCATAGAACGAAAGG -> GGCTGCATAGAACGAAAGGT
TGGGAATATAATTCTAGCGT -> GGGAATATAATTCTAGCGTA
TGGGAGGCACTAATCCGACG -> GGGAGGCACTAATCCGACGA
TGGGCTATAGGTTTGCACCC -> GGGCTATAGGTTTGCACCCA
TGGGTGGGCTATAGGTTTGC -> GGGTGGGCTATAGGTTTGCA
TGGGTTGGCCTTTACCCGGA -> GGGTTGGCCTTTACCCGGAA
TGGTAGGCGTCCGTCGGTAA -> GGTAGGCGTCCGTCGGTAAA
TGGTATTCTTCGGCGGCAAT -> GGTATTCTTCGGCGGCAATT
TGTAAAGAGGTGGAACTATG -> GTAAAGAGGTGGAACTATGC
TGTAAGGGGATAGTCAACCA -> GTAAGGGGATAGTCAACCAA
TGTAGAAATCAAGTGAACCA -> GTAGAAATCAAGTGAACCAC
TGTAGGTGACATAAATAGCA -> GTAGGTGACATAAATAGCAC
TGTCCGATTTACCAGCTGCG -> GTCCGATTTACCAGCTGCGG
TGTCTAGCGTGGCATACCAA -> GTCTAGCGTGGCATACCAAC
TGTCTGGGTTGGCCTTTACC -> GTCTGGGTTGGCCTTTACCC
TGTCTTGTGCTACGTTTCGA -> GTCTTGTGCTACGTTTCGAC
TGTGAGTACCCCGCGTATGT -> GTGAGTACCCCGCGTATGTT
TGTGCTACGTTTCGACGAAG -> GTGCTACGTTTCGACGAAGT
TGTGGACATCTCCCCAGATC -> GTGGACATCTCCCCAGATCA
TGTGTCTTGTGCTACGTTTC -> GTGTCTTGTGCTACGTTTCG
TGTTCGATAAACGCAGGATG -> GTTCGATAAACGCAGGATGG
TGTTCTCCCACACCTTATCA -> GTTCTCCCACACCTTATCAA
TGTTGATACACTGGAGCCAG -> GTTGATACACTGGAGCCAGG
TGTTTGAGTTGATGGACATT -> GTTTGAGTTGATGGACATTA
TTAACACGGGCGGTTGGAAG -> TAACACGGGCGGTTGGAAGA
TTACCAGCTGCGGCCGGACG -> TACCAGCTGCGGCCGGACGA
TTACCCGCAAGATGTCCGAT -> TACCCGCAAGATGTCCGATT
TTACCCGGAAGAGATCACAC -> TACCCGGAAGAGATCACACT
TTACCTGTTCGATAAACGCA -> TACCTGTTCGATAAACGCAG
TTACGGACAATGGCTCAATC -> TACGGACAATGGCTCAATCC
TTACGTGCCCTTCTAAAAGG -> TACGTGCCCTTCTAAAAGGT
TTACTCTCGTACTAGCCCGC -> TACTCTCGTACTAGCCCGCG
TTAGGCGCGACAGGACTTGC -> TAGGCGCGACAGGACTTGCC
TTAGTATACCTCACCAATCC -> TAGTATACCTCACCAATCCT
TTAGTATGGCGTGCATATAG -> TAGTATGGCGTGCATATAGT
TTAGTGAATATACCCCGTCG -> TAGTGAATATACCCCGTCGT
TTATCAACAACATTTATGGC -> TATCAACAACATTTATGGCT
TTATGGCTGCATAGAACGAA -> TATGGCTGCATAGAACGAAA
TTCGACGAAGTGGTATTCTT -> TCGACGAAGTGGTATTCTTC
TTCGATAAACGCAGGATGGG -> TCGATAAACGCAGGATGGGA
TTCGGCGGCAATTACGTGCC -> TCGGCGGCAATTACGTGCCC
TTCTAAAAGGTCAGGAATAT -> TCTAAAAGGTCAGGAATATA
TTCTAATCTCGAAATGGTAG -> TCTAATCTCGAAATGGTAGG
TTCTAGCGTATACGATACAT -> TCTAGCGTATACGATACATT
TTCTATGACGTTACCCGCAA -> TCTATGACGTTACCCGCAAG
TTCTCCCACACCTTATCAAC -> TCTCCCACACCTTATCAACA
TTCTTACGGACAATGGCTCA -> TCTTACGGACAATGGCTCAA
TTCTTCGGCGGCAATTACGT -> TCTTCGGCGGCAATTACGTG
TTGAAAATACGAGGCGAAGC -> TGAAAATACGAGGCGAAGCT
TTGAGTTGATGGACATTAGT -> TGAGTTGATGGACATTAGTA
TTGATACACTGGAGCCAGGA -> TGATACACTGGAGCCAGGAC
TTGATGCCCCACTAGTACTC -> TGATGCCCCACTAGTACTCA
TTGATGGACATTAGTATACC -> TGATGGACATTAGTATACCT
TTGATTTTACCTGTTCGATA -> TGATTTTACCTGTTCGATAA
TTGCACCCAACCGTGTCTAG -> TGCACCCAACCGTGTCTAGC
TTGCCGGTGTCTGGGTTGGC -> TGCCGGTGTCTGGGTTGGCC
TTGGAAGACAAAGTTGATGC -> TGGAAGACAAAGTTGATGCC
TTGGCCTTTACCCGGAAGAG -> TGGCCTTTACCCGGAAGAGA
TTGGGAGGCACTAATCCGAC -> TGGGAGGCACTAATCCGACG
TTGGGTGGGCTATAGGTTTG -> TGGGTGGGCTATAGGTTTGC
TTGTAAAGAGGTGGAACTAT -> TGTAAAGAGGTGGAACTATG
TTGTAGGTGACATAAATAGC -> TGTAGGTGACATAAATAGCA
TTGTGCTACGTTTCGACGAA -> TGTGCTACGTTTCGACGAAG
TTTACCAGCTGCGGCCGGAC -> TTACCAGCTGCGGCCGGACG
TTTACCCGGAAGAGATCACA -> TTACCCGGAAGAGATCACAC
TTTACCTGTTCGATAAACGC -> TTACCTGTTCGATAAACGCA
TTTATGGCTGCATAGAACGA -> TTATGGCTGCATAGAACGAA
TTTCGACGAAGTGGTATTCT -> TTCGACGAAGTGGTATTCTT
TTTCTTACGGACAATGGCTC -> TTCTTACGGACAATGGCTCA
TTTGAGTTGATGGACATTAG -> TTGAGTTGATGGACATTAGT
TTTGCACCCAACCGTGTCTA -> TTGCACCCAACCGTGTCTAG
TTTGGGTGGGCTATAGGTTT -> TTGGGTGGGCTATAGGTTTG
TTTTACCTGTTCGATAAACG -> TTTACCTGTTCGATAAACGC
