AAAAAATCGAATGCGATTG -> AAAAATCGAATGCGATTGT
AAAAATCGAATGCGATTGT -> AAAATCGAATGCGATTGTG
AAAACCGCGGCAGGAACAA -> AAACCGCGGCAGGAACAAT
AAAACGCATGACTTTATCA -> AAACGCATGACTTTATCAC
AAAACTACGGAAGATCGCT -> AAACTACGGAAGATCGCTC
AAAATATCGATTCTGTACT -> AAATATCGATTCTGTACTA
AAAATCGAATGCGATTGTG -> AAATCGAATGCGATTGTGA
AAAATGTGACTGACCGCCA -> AAATGTGACTGACCGCCAC
AAAATTGATAGAAACATAC -> AAATTGATAGAAACATACC
AAACAGCCTCCCACTAGCT -> AACAGCCTCCCACTAGCTT
AAACATACCCAAGGGTGTC -> AACATACCCAAGGGTGTCT
AAACCGCGGCAGGAACAAT -> AACCGCGGCAGGAACAATC
AAACCTATAGGCAGTGTTT -> AACCTATAGGCAGTGTTTT
AAACGCATGACTTTATCAC -> AACGCATGACTTTATCACC
AAACGTAAACAGCCTCCCA -> AACGTAAACAGCCTCCCAC
AAACGTAGTGTTTGCTTAG -> AACGTAGTGTTTGCTTAGC
AAACTACGGAAGATCGCTC -> AACTACGGAAGATCGCTCA
AAAGAAAGTGTATCGTCGG -> AAGAAAGTGTATCGTCGGC
AAAGACAACAGAACTGTAT -> AAGACAACAGAACTGTATC
AAAGCCCGGTTTGTCTGAT -> AAGCCCGGTTTGTCTGATG
AAAGCGCCTCCGCCTAAGG -> AAGCGCCTCCGCCTAAGGC
AAAGGAAGCGGGATTCTGT -> AAGGAAGCGGGATTCTGTG
AAAGTGTATCGTCGGCTGT -> AAGTGTATCGTCGGCTGTT
AAATAATGGCAGCCATGTT -> AATAATGGCAGCCATGTTG
AAATAGATGAAATCTCTAG -> AATAGATGAAATCTCTAGG
AAATATCGATTCTGTACTA -> AATATCGATTCTGTACTAA
AAATCGAATGCGATTGTGA -> AATCGAATGCGATTGTGAG
AAATCGATTCACGTACTGG -> AATCGATTCACGTACTGGT
AAATCTCAGACCCAAGGGA -> AATCTCAGACCCAAGGGAA
AAATCTCTAGGTACTTTAC -> AATCTCTAGGTACTTTACG
AAATCTTCGATAGGCCCCA -> AATCTTCGATAGGCCCCAC
AAATGCGGGCCCGCTGTGT -> AATGCGGGCCCGCTGTGTT
AAATGTCGCAAGGGAGAAT -> AATGTCGCAAGGGAGAATG
AAATGTGACTGACCGCCAC -> AATGTGACTGACCGCCACG
AAATTAAGAACCGAGTAAC -> AATTAAGAACCGAGTAACT
AAATTGATAGAAACATACC -> AATTGATAGAAACATACCC
AACAAAACCGCGGCAGGAA -> ACAAAACCGCGGCAGGAAC
AACAATCCGCGGAGGTACG -> ACAATCCGCGGAGGTACGC
AACACAAAATATCGATTCT -> ACACAAAATATCGATTCTG
AACAGAACTGTATCTAATA -> ACAGAACTGTATCTAATAG
AACAGAACTGTATCTAGGA -> ACAGAACTGTATCTAGGAA
AACAGAACTGTATCTATTG -> ACAGAACTGTATCTATTGC
AACAGAACTGTATCTTCGA -> ACAGAACTGTATCTTCGAA
AACAGCCTCCCACTAGCTT -> ACAGCCTCCCACTAGCTTT
AACATACCCAAGGGTGTCT -> ACATACCCAAGGGTGTCTA
AACCAATCGCATTGTATAT -> ACCAATCGCATTGTATATA
AACCATCCGTTATTTCGAA -> ACCATCCGTTATTTCGAAG
AACCCGGCAAATCTCAGAC -> ACCCGGCAAATCTCAGACC
AACCCGTGGACGCCGATCT -> ACCCGTGGACGCCGATCTT
AACCGAGTAACTTGTAAAT -> ACCGAGTAACTTGTAAATC
AACCGCGGCAGGAACAATC -> ACCGCGGCAGGAACAATCC
AACCGTGCCACGTTCGACC -> ACCGTGCCACGTTCGACCG
AACCTATAGGCAGTGTTTT -> ACCTATAGGCAGTGTTTTA
AACCTTTCATGGACCTGTC -> ACCTTTCATGGACCTGTCT
AACGCATGACTTTATCACC -> ACGCATGACTTTATCACCA
AACGGATTTATAGGAAAAC -> ACGGATTTATAGGAAAACG
AACGTAAACAGCCTCCCAC -> ACGTAAACAGCCTCCCACT
AACGTAGTGTTTGCTTAGC -> ACGTAGTGTTTGCTTAGCG
AACTACGGAAGATCGCTCA -> ACTACGGAAGATCGCTCAA
AACTAGGAAATGTCGCAAG -> ACTAGGAAATGTCGCAAGG
AACTGTATCTAATAGGTCT -> ACTGTATCTAATAGGTCTC
AACTGTATCTAGGAAAATT -> ACTGTATCTAGGAAAATTG
AACTGTATCTATTGCAGTA -> ACTGTATCTATTGCAGTAT
AACTGTATCTTCGAAGCTA -> ACTGTATCTTCGAAGCTAA
AACTTGTAAATCTTCGATA -> ACTTGTAAATCTTCGATAG
AACTTGTTAGCGTCGACGG -> ACTTGTTAGCGTCGACGGT
AACTTTGTTAACTAGGAAA -> ACTTTGTTAACTAGGAAAT
AAGAAAACTACGGAAGATC -> AGAAAACTACGGAAGATCG
AAGAAAGTGTATCGTCGGC -> AGAAAGTGTATCGTCGGCT
AAGAACCGAGTAACTTGTA -> AGAACCGAGTAACTTGTAA
AAGAAGCTGCGATCCAGGT -> AGAAGCTGCGATCCAGGTG
AAGACAACAGAACTGTATC -> AGACAACAGAACTGTATCT,AGACAACAGAACTGTATCT
AAGACCGCACTATCAAAGG -> AGACCGCACTATCAAAGGA
AAGACTCCATCCATACGAT -> AGACTCCATCCATACGATG
AAGATATATAAATAGATGA -> AGATATATAAATAGATGAA
AAGATCGCTCAACCCGTGG -> AGATCGCTCAACCCGTGGA
AAGCCCGGTTTGTCTGATG -> AGCCCGGTTTGTCTGATGC
AAGCCTCAAGGCTACAATA -> AGCCTCAAGGCTACAATAC
AAGCGCCTCCGCCTAAGGC -> AGCGCCTCCGCCTAAGGCC
AAGCGGGATTCTGTGCTAC -> AGCGGGATTCTGTGCTACG
AAGCTAATCTCTAAATAAT -> AGCTAATCTCTAAATAATG
AAGCTGATTATATTTTGTC -> AGCTGATTATATTTTGTCA
AAGCTGCGATCCAGGTGCA -> AGCTGCGATCCAGGTGCAC
AAGGAAGATATATAAATAG -> AGGAAGATATATAAATAGA
AAGGAAGCGGGATTCTGTG -> AGGAAGCGGGATTCTGTGC
AAGGCCCCTTTAGGAGTAA -> AGGCCCCTTTAGGAGTAAG
AAGGCCTACAGAGACGTAG -> AGGCCTACAGAGACGTAGG
AAGGCTACAATACTAGAAG -> AGGCTACAATACTAGAAGG
AAGGCTCCTCCAGCCCGGG -> AGGCTCCTCCAGCCCGGGC
AAGGCTTACGTAGCCGCTT -> AGGCTTACGTAGCCGCTTA
AAGGGAAAAAATCGAATGC -> AGGGAAAAAATCGAATGCG
AAGGGAGAATGAGTACAAG -> AGGGAGAATGAGTACAAGA
AAGGGATACATTCTTGTAG -> AGGGATACATTCTTGTAGT
AAGGGTACGTTTTATTATT -> AGGGTACGTTTTATTATTA
AAGGGTGTCTAGGGCACGC -> AGGGTGTCTAGGGCACGCC
AAGGTACAGTAATTGGTTT -> AGGTACAGTAATTGGTTTT
AAGGTTCTCCTGTCTTATC -> AGGTTCTCCTGTCTTATCT
AAGTAGGTCCCCCCTTGTT -> AGTAGGTCCCCCCTTGTTG
AAGTATACGAGCATCTGGA -> AGTATACGAGCATCTGGAA
AAGTGCTGGTACGTTGCTC -> AGTGCTGGTACGTTGCTCC
AAGTGTATCGTCGGCTGTT -> AGTGTATCGTCGGCTGTTT
AATAATGGCAGCCATGTTG -> ATAATGGCAGCCATGTTGG
AATAATTTCCGGGACTTCC -> ATAATTTCCGGGACTTCCA
AATACACTGTGCGTAAAGA -> ATACACTGTGCGTAAAGAA
AATACATTAACACAAAATA -> ATACATTAACACAAAATAT
AATACTAGAAGGCCTACAG -> ATACTAGAAGGCCTACAGA
AATAGATGAAATCTCTAGG -> ATAGATGAAATCTCTAGGT
AATAGGTCTCAATCTCATG -> ATAGGTCTCAATCTCATGG
AATATCGATTCTGTACTAA -> ATATCGATTCTGTACTAAT
AATATGAACCGTGCCACGT -> ATATGAACCGTGCCACGTT
AATATTTGAAAATGTGACT -> ATATTTGAAAATGTGACTG
AATCACGGGTTAAGACCGC -> ATCACGGGTTAAGACCGCA
AATCCGCGGAGGTACGCCT -> ATCCGCGGAGGTACGCCTG
AATCCTAGCCCGTAGCGTT -> ATCCTAGCCCGTAGCGTTT
AATCGAATGCGATTGTGAG -> ATCGAATGCGATTGTGAGG
AATCGATTCACGTACTGGT -> ATCGATTCACGTACTGGTC
AATCGCATTGTATATATAG -> ATCGCATTGTATATATAGA
AATCTCAGACCCAAGGGAA -> ATCTCAGACCCAAGGGAAA
AATCTCATGGTACCGTAGT -> ATCTCATGGTACCGTAGTT
AATCTCTAAATAATGGCAG -> ATCTCTAAATAATGGCAGC
AATCTCTAGGTACTTTACG -> ATCTCTAGGTACTTTACGC
AATCTGGTTCAAACCTATA -> ATCTGGTTCAAACCTATAG
AATCTTCGATAGGCCCCAC -> ATCTTCGATAGGCCCCACG
AATCTTTGGTATAGGTGAA -> ATCTTTGGTATAGGTGAAG
AATGAGGGATATCTGATCC -> ATGAGGGATATCTGATCCC
AATGAGTACAAGAAGCTGC -> ATGAGTACAAGAAGCTGCG
AATGATCAAGGCTTACGTA -> ATGATCAAGGCTTACGTAG
AATGCGATTGTGAGGTCTT -> ATGCGATTGTGAGGTCTTT
AATGCGGGCCCGCTGTGTT -> ATGCGGGCCCGCTGTGTTG
AATGGCAGCCATGTTGGCT -> ATGGCAGCCATGTTGGCTT
AATGTCGCAAGGGAGAATG -> ATGTCGCAAGGGAGAATGA
AATGTCTCACCTAATATGA -> ATGTCTCACCTAATATGAA
AATGTCTTAAACGTAAACA -> ATGTCTTAAACGTAAACAG
AATGTGACTGACCGCCACG -> ATGTGACTGACCGCCACGT
AATTAAGAACCGAGTAACT -> ATTAAGAACCGAGTAACTT
AATTGATAGAAACATACCC -> ATTGATAGAAACATACCCA
AATTGGTTTTAATCTGGTT -> ATTGGTTTTAATCTGGTTC
AATTGTGTATTTGCCCATC -> ATTGTGTATTTGCCCATCT
AATTGTGTTCCCTGTCCAC -> ATTGTGTTCCCTGTCCACG
AATTGTTCACGTGGTGGCC -> ATTGTTCACGTGGTGGCCA
AATTTCCGGGACTTCCAGT -> ATTTCCGGGACTTCCAGTC
ACAAAACCGCGGCAGGAAC -> CAAAACCGCGGCAGGAACA
ACAAAATATCGATTCTGTA -> CAAAATATCGATTCTGTAC
ACAAATTAAGAACCGAGTA -> CAAATTAAGAACCGAGTAA
ACAACAGAACTGTATCTAA -> CAACAGAACTGTATCTAAT
ACAACAGAACTGTATCTAG -> CAACAGAACTGTATCTAGG
ACAACAGAACTGTATCTAT -> CAACAGAACTGTATCTATT
ACAACAGAACTGTATCTTC -> CAACAGAACTGTATCTTCG
ACAACCAATCGCATTGTAT -> CAACCAATCGCATTGTATA
ACAAGAAGCTGCGATCCAG -> CAAGAAGCTGCGATCCAGG
ACAATACTAGAAGGCCTAC -> CAATACTAGAAGGCCTACA
ACAATCCGCGGAGGTACGC -> CAATCCGCGGAGGTACGCC
ACACAAAATATCGATTCTG -> CACAAAATATCGATTCTGT
ACACCTTTCAAACGTAGTG -> CACCTTTCAAACGTAGTGT
ACACTGTGCGTAAAGAAAG -> CACTGTGCGTAAAGAAAGT
ACACTTACGTGATCGTTGG -> CACTTACGTGATCGTTGGA
ACACTTATAACGGATTTAT -> CACTTATAACGGATTTATA
ACAGAACTGTATCTAATAG -> CAGAACTGTATCTAATAGG
ACAGAACTGTATCTAGGAA -> CAGAACTGTATCTAGGAAA
ACAGAACTGTATCTATTGC -> CAGAACTGTATCTATTGCA
ACAGAACTGTATCTTCGAA -> CAGAACTGTATCTTCGAAG
ACAGAGACGTAGGGCATTT -> CAGAGACGTAGGGCATTTT
ACAGCCTCCCACTAGCTTT -> CAGCCTCCCACTAGCTTTA
ACAGCGTCGTTCGGAGATC -> CAGCGTCGTTCGGAGATCG
ACAGTAATTGGTTTTAATC -> CAGTAATTGGTTTTAATCT
ACAGTGCAGAGTTAAATGC -> CAGTGCAGAGTTAAATGCG
ACAGTTAGAGTTTCAACCC -> CAGTTAGAGTTTCAACCCG
ACATACCCAAGGGTGTCTA -> CATACCCAAGGGTGTCTAG
ACATCCGGCTATTGCAGTC -> CATCCGGCTATTGCAGTCT
ACATGACTACTTTGAACCT -> CATGACTACTTTGAACCTT
ACATTAACACAAAATATCG -> CATTAACACAAAATATCGA
ACATTCTTGTAGTCATTAC -> CATTCTTGTAGTCATTACA
ACCAATCGCATTGTATATA -> CCAATCGCATTGTATATAT
ACCAATGTCTTAAACGTAA -> CCAATGTCTTAAACGTAAA
ACCAGATGGCGCGGACACT -> CCAGATGGCGCGGACACTT
ACCAGCCACGTTCGACCGA -> CCAGCCACGTTCGACCGAC
ACCATCCGTTATTTCGAAG -> CCATCCGTTATTTCGAAGC
ACCCAAGGGAAAAAATCGA -> CCCAAGGGAAAAAATCGAA
ACCCAAGGGTGTCTAGGGC -> CCCAAGGGTGTCTAGGGCA
ACCCAGCTACTGTCAAGAC -> CCCAGCTACTGTCAAGACA
ACCCATCAGTCATGAGCGT -> CCCATCAGTCATGAGCGTG
ACCCCTTGTGCGGTCAGAC -> CCCCTTGTGCGGTCAGACA
ACCCGGCAAATCTCAGACC -> CCCGGCAAATCTCAGACCC
ACCCGGTCGTATCAAAGAC -> CCCGGTCGTATCAAAGACA
ACCCGTGGACGCCGATCTT -> CCCGTGGACGCCGATCTTT
ACCCTACCTTGGAGGAGAC -> CCCTACCTTGGAGGAGACA
ACCCTCCCCACCTAACAAA -> CCCTCCCCACCTAACAAAA
ACCGACCCAGCTACTGTCA -> CCGACCCAGCTACTGTCAA
ACCGACCCCTTGTGCGGTC -> CCGACCCCTTGTGCGGTCA
ACCGACCCGGTCGTATCAA -> CCGACCCGGTCGTATCAAA
ACCGACCCTACCTTGGAGG -> CCGACCCTACCTTGGAGGA
ACCGAGTAACTTGTAAATC -> CCGAGTAACTTGTAAATCT
ACCGCACTATCAAAGGAAG -> CCGCACTATCAAAGGAAGC
ACCGCCACGTTCGACCGAC -> CCGCCACGTTCGACCGACC
ACCGCGCTATCGCGGGGTC -> CCGCGCTATCGCGGGGTCC
ACCGCGGCAGGAACAATCC -> CCGCGGCAGGAACAATCCG
ACCGTAGTTGATTCGACTT -> CCGTAGTTGATTCGACTTT
ACCGTGCCACGTTCGACCG -> CCGTGCCACGTTCGACCGA
ACCTAACAAAACCGCGGCA -> CCTAACAAAACCGCGGCAG
ACCTAATATGAACCGTGCC -> CCTAATATGAACCGTGCCA
ACCTATAGGCAGTGTTTTA -> CCTATAGGCAGTGTTTTAT
ACCTGTCTTGCTCGACAGC -> CCTGTCTTGCTCGACAGCG
ACCTGTGTCGCGCCAGTAG -> CCTGTGTCGCGCCAGTAGT
ACCTTGGAGGAGACAACAG -> CCTTGGAGGAGACAACAGA
ACCTTTCAAACGTAGTGTT -> CCTTTCAAACGTAGTGTTT
ACCTTTCATGGACCTGTCT -> CCTTTCATGGACCTGTCTT
ACGACACCTTTCAAACGTA -> CGACACCTTTCAAACGTAG
ACGACCCTCCCCACCTAAC -> CGACCCTCCCCACCTAACA
ACGAGCATCTGGAAGGGAT -> CGAGCATCTGGAAGGGATA
ACGAGCTCTGTATGGCTAA -> CGAGCTCTGTATGGCTAAT
ACGATAGGCCCTCGACACT -> CGATAGGCCCTCGACACTT
ACGATGGGATTATAGATAG -> CGATGGGATTATAGATAGC
ACGCATGACTTTATCACCA -> CGCATGACTTTATCACCAG
ACGCCCATTCTCCAAGGCT -> CGCCCATTCTCCAAGGCTC
ACGCCGATCTTTAGACAGT -> CGCCGATCTTTAGACAGTG
ACGCCTGATCCCCGCAAGG -> CGCCTGATCCCCGCAAGGG
ACGCGAGTTCTTACTGTCT -> CGCGAGTTCTTACTGTCTC
ACGCTACTGAATACACTGT -> CGCTACTGAATACACTGTG
ACGGAAGATCGCTCAACCC -> CGGAAGATCGCTCAACCCG
ACGGATTTATAGGAAAACG -> CGGATTTATAGGAAAACGC
ACGGCTGAGCCTCGGCTGT -> CGGCTGAGCCTCGGCTGTG
ACGGGTAGCATTTGGTAAG -> CGGGTAGCATTTGGTAAGA
ACGGGTTAAGACCGCACTA -> CGGGTTAAGACCGCACTAT
ACGGTAATTGTGTTCCCTG -> CGGTAATTGTGTTCCCTGT
ACGTAAACAGCCTCCCACT -> CGTAAACAGCCTCCCACTA
ACGTACTGGTCACTGCCCC -> CGTACTGGTCACTGCCCCA
ACGTAGCCGCTTACCGCGC -> CGTAGCCGCTTACCGCGCT
ACGTAGGGCATTTTGATCG -> CGTAGGGCATTTTGATCGA
ACGTAGTGTTTGCTTAGCG -> CGTAGTGTTTGCTTAGCGC
ACGTGATCGTTGGAAAGCC -> CGTGATCGTTGGAAAGCCC
ACGTGCTAAGTGCTGGTAC -> CGTGCTAAGTGCTGGTACG
ACGTGGTGGCCACGTTCGA -> CGTGGTGGCCACGTTCGAC
ACGTTCGACCGACCCAGCT -> CGTTCGACCGACCCAGCTA
ACGTTCGACCGACCCCTTG -> CGTTCGACCGACCCCTTGT
ACGTTCGACCGACCCGGTC -> CGTTCGACCGACCCGGTCG
ACGTTCGACCGACCCTACC -> CGTTCGACCGACCCTACCT
ACGTTGCTCCGAAATCGAT -> CGTTGCTCCGAAATCGATT
ACGTTTTATTATTACCTGT -> CGTTTTATTATTACCTGTG
ACTAATAATTTCCGGGACT -> CTAATAATTTCCGGGACTT
ACTACGGAAGATCGCTCAA -> CTACGGAAGATCGCTCAAC
ACTACTTTGAACCTTTCAT -> CTACTTTGAACCTTTCATG
ACTAGAAGGCCTACAGAGA -> CTAGAAGGCCTACAGAGAC
ACTAGCTTTAAGAAAACTA -> CTAGCTTTAAGAAAACTAC
ACTAGGAAATGTCGCAAGG -> CTAGGAAATGTCGCAAGGG
ACTATCAAAGGAAGCGGGA -> CTATCAAAGGAAGCGGGAT
ACTCAAGTAGGTCCCCCCT -> CTCAAGTAGGTCCCCCCTT
ACTCCATCCATACGATGGG -> CTCCATCCATACGATGGGA
ACTCGCCGCGGACTGTGGT -> CTCGCCGCGGACTGTGGTG
ACTGAATACACTGTGCGTA -> CTGAATACACTGTGCGTAA
ACTGACCGCCACGTTCGAC -> CTGACCGCCACGTTCGACC
ACTGCCCCATGAGCCTACG -> CTGCCCCATGAGCCTACGA
ACTGGTCACTGCCCCATGA -> CTGGTCACTGCCCCATGAG
ACTGTATCTAATAGGTCTC -> CTGTATCTAATAGGTCTCA
ACTGTATCTAGGAAAATTG -> CTGTATCTAGGAAAATTGA
ACTGTATCTATTGCAGTAT -> CTGTATCTATTGCAGTATG
ACTGTATCTTCGAAGCTAA -> CTGTATCTTCGAAGCTAAT
ACTGTCAAGACAACAGAAC -> CTGTCAAGACAACAGAACT
ACTGTCTCCATCCATCAAT -> CTGTCTCCATCCATCAATA
ACTGTGCGTAAAGAAAGTG -> CTGTGCGTAAAGAAAGTGT
ACTGTGGTGTAGAACGCTC -> CTGTGGTGTAGAACGCTCA
ACTTACGTGATCGTTGGAA -> CTTACGTGATCGTTGGAAA
ACTTATAACGGATTTATAG -> CTTATAACGGATTTATAGG
ACTTCCAGTCTTTAATCAC -> CTTCCAGTCTTTAATCACG
ACTTGTAAATCTTCGATAG -> CTTGTAAATCTTCGATAGG
ACTTGTTAGCGTCGACGGT -> CTTGTTAGCGTCGACGGTA
ACTTTACGCTACTGAATAC -> CTTTACGCTACTGAATACA
ACTTTATCACCAGCCACGT -> CTTTATCACCAGCCACGTT
ACTTTCCATCCGGGTTCCA -> CTTTCCATCCGGGTTCCAG
ACTTTGAACCTTTCATGGA -> CTTTGAACCTTTCATGGAC
ACTTTGTTAACTAGGAAAT -> CTTTGTTAACTAGGAAATG
AGAAAACTACGGAAGATCG -> GAAAACTACGGAAGATCGC
AGAAACATACCCAAGGGTG -> GAAACATACCCAAGGGTGT
AGAAAGTGTATCGTCGGCT -> GAAAGTGTATCGTCGGCTG
AGAACCGAGTAACTTGTAA -> GAACCGAGTAACTTGTAAA
AGAACTGTATCTAATAGGT -> GAACTGTATCTAATAGGTC
AGAACTGTATCTAGGAAAA -> GAACTGTATCTAGGAAAAT
AGAACTGTATCTATTGCAG -> GAACTGTATCTATTGCAGT
AGAACTGTATCTTCGAAGC -> GAACTGTATCTTCGAAGCT
AGAAGCTGCGATCCAGGTG -> GAAGCTGCGATCCAGGTGC
AGAAGGCCTACAGAGACGT -> GAAGGCCTACAGAGACGTA
AGAATGAGTACAAGAAGCT -> GAATGAGTACAAGAAGCTG
AGAATGTCTCACCTAATAT -> GAATGTCTCACCTAATATG
AGAATTGTTCACGTGGTGG -> GAATTGTTCACGTGGTGGC
AGACAACAGAACTGTATCT -> GACAACAGAACTGTATCTA,GACAACAGAACTGTATCTA,GACAACAGAACTGTATCTA,GACAACAGAACTGTATCTT
AGACAGTGCAGAGTTAAAT -> GACAGTGCAGAGTTAAATG
AGACCCAAGGGAAAAAATC -> GACCCAAGGGAAAAAATCG
AGACCGCACTATCAAAGGA -> GACCGCACTATCAAAGGAA
AGACGTAGGGCATTTTGAT -> GACGTAGGGCATTTTGATC
AGACTCCATCCATACGATG -> GACTCCATCCATACGATGG
AGAGACGTAGGGCATTTTG -> GAGACGTAGGGCATTTTGA
AGAGCGTCCCGAGGGAATA -> GAGCGTCCCGAGGGAATAC
AGAGGGTTCCGTCTCTGAC -> GAGGGTTCCGTCTCTGACA
AGAGTTAAATGCGGGCCCG -> GAGTTAAATGCGGGCCCGC
AGAGTTTCAACCCGGCAAA -> GAGTTTCAACCCGGCAAAT
AGATAGCAGTCAATGATCA -> GATAGCAGTCAATGATCAA
AGATATATAAATAGATGAA -> GATATATAAATAGATGAAA
AGATCCAGTGAGTTTGGAC -> GATCCAGTGAGTTTGGACA
AGATCGCTCAACCCGTGGA -> GATCGCTCAACCCGTGGAC
AGATCGGGGAGCCACCAGA -> GATCGGGGAGCCACCAGAT
AGATGAAATCTCTAGGTAC -> GATGAAATCTCTAGGTACT
AGATGGCGCGGACACTTAT -> GATGGCGCGGACACTTATA
AGCAGTCAATGATCAAGGC -> GCAGTCAATGATCAAGGCT
AGCATCTGGAAGGGATACA -> GCATCTGGAAGGGATACAT
AGCATTTGGTAAGACTCCA -> GCATTTGGTAAGACTCCAT
AGCCACCAGATGGCGCGGA -> GCCACCAGATGGCGCGGAC
AGCCACGTTCGACCGACCC -> GCCACGTTCGACCGACCCA
AGCCAGGGAAAGCGCCTCC -> GCCAGGGAAAGCGCCTCCG
AGCCATGTTGGCTTGTCTG -> GCCATGTTGGCTTGTCTGG
AGCCCGGGCGTTTGCATTC -> GCCCGGGCGTTTGCATTCG
AGCCCGGTTTGTCTGATGC -> GCCCGGTTTGTCTGATGCC
AGCCCGTAGCGTTTGGTCA -> GCCCGTAGCGTTTGGTCAT
AGCCGCAAGCCTCAAGGCT -> GCCGCAAGCCTCAAGGCTA
AGCCGCTTACCGCGCTATC -> GCCGCTTACCGCGCTATCG
AGCCTACGAGCTCTGTATG -> GCCTACGAGCTCTGTATGG
AGCCTCAAGGCTACAATAC -> GCCTCAAGGCTACAATACT
AGCCTCCCACTAGCTTTAA -> GCCTCCCACTAGCTTTAAG
AGCCTCGGCTGTGGCTACG -> GCCTCGGCTGTGGCTACGT
AGCGCCTCCGCCTAAGGCC -> GCGCCTCCGCCTAAGGCCC
AGCGCTCGCGTTCAAGTAT -> GCGCTCGCGTTCAAGTATA
AGCGGGATTCTGTGCTACG -> GCGGGATTCTGTGCTACGA
AGCGTCCCGAGGGAATACA -> GCGTCCCGAGGGAATACAT
AGCGTCGACGGTAATTGTG -> GCGTCGACGGTAATTGTGT
AGCGTCGTTCGGAGATCGG -> GCGTCGTTCGGAGATCGGG
AGCGTGCGGAGATCCAGTG -> GCGTGCGGAGATCCAGTGA
AGCGTTTGGTCATTGGAGA -> GCGTTTGGTCATTGGAGAG
AGCTAACTTGTTAGCGTCG -> GCTAACTTGTTAGCGTCGA
AGCTAATCTCTAAATAATG -> GCTAATCTCTAAATAATGG
AGCTACTGTCAAGACAACA -> GCTACTGTCAAGACAACAG
AGCTCTGTATGGCTAATCC -> GCTCTGTATGGCTAATCCT
AGCTGATTATATTTTGTCA -> GCTGATTATATTTTGTCAC
AGCTGCGATCCAGGTGCAC -> GCTGCGATCCAGGTGCACT
AGCTTTAAGAAAACTACGG -> GCTTTAAGAAAACTACGGA
AGGAAAACGCATGACTTTA -> GGAAAACGCATGACTTTAT
AGGAAAATTGATAGAAACA -> GGAAAATTGATAGAAACAT
AGGAAATGTCGCAAGGGAG -> GGAAATGTCGCAAGGGAGA
AGGAACAATCCGCGGAGGT -> GGAACAATCCGCGGAGGTA
AGGAAGATATATAAATAGA -> GGAAGATATATAAATAGAT
AGGAAGCGGGATTCTGTGC -> GGAAGCGGGATTCTGTGCT
AGGAGACAACAGAACTGTA -> GGAGACAACAGAACTGTAT
AGGAGTAAGGTTCTCCTGT -> GGAGTAAGGTTCTCCTGTC
AGGATGCGTGACCAATGTC -> GGATGCGTGACCAATGTCT
AGGCAGTGTTTTATTTGCG -> GGCAGTGTTTTATTTGCGG
AGGCCCCACGGGTAGCATT -> GGCCCCACGGGTAGCATTT
AGGCCCCTTTAGGAGTAAG -> GGCCCCTTTAGGAGTAAGG
AGGCCCTCGACACTTACGT -> GGCCCTCGACACTTACGTG
AGGCCTACAGAGACGTAGG -> GGCCTACAGAGACGTAGGG
AGGCTACAATACTAGAAGG -> GGCTACAATACTAGAAGGC
AGGCTCCTCCAGCCCGGGC -> GGCTCCTCCAGCCCGGGCG
AGGCTTACGTAGCCGCTTA -> GGCTTACGTAGCCGCTTAC
AGGGAAAAAATCGAATGCG -> GGGAAAAAATCGAATGCGA
AGGGAAAGCGCCTCCGCCT -> GGGAAAGCGCCTCCGCCTA
AGGGAATACATTAACACAA -> GGGAATACATTAACACAAA
AGGGAGAATGAGTACAAGA -> GGGAGAATGAGTACAAGAA
AGGGATACATTCTTGTAGT -> GGGATACATTCTTGTAGTC
AGGGATATCTGATCCCGTG -> GGGATATCTGATCCCGTGA
AGGGCACGCCCATTCTCCA -> GGGCACGCCCATTCTCCAA
AGGGCATTTTGATCGATCG -> GGGCATTTTGATCGATCGA
AGGGTACGTTTTATTATTA -> GGGTACGTTTTATTATTAC
AGGGTGTCTAGGGCACGCC -> GGGTGTCTAGGGCACGCCC
AGGGTTCCGTCTCTGACAT -> GGGTTCCGTCTCTGACATG
AGGTACAGTAATTGGTTTT -> GGTACAGTAATTGGTTTTA
AGGTACGCCTGATCCCCGC -> GGTACGCCTGATCCCCGCA
AGGTACTTTACGCTACTGA -> GGTACTTTACGCTACTGAA
AGGTCCCCCCTTGTTGGGA -> GGTCCCCCCTTGTTGGGAA
AGGTCTCAATCTCATGGTA -> GGTCTCAATCTCATGGTAC
AGGTCTTTTAGTGACTCGC -> GGTCTTTTAGTGACTCGCC
AGGTGAAGGAAGATATATA -> GGTGAAGGAAGATATATAA
AGGTGCACTCAAGTAGGTC -> GGTGCACTCAAGTAGGTCC
AGGTTCTCCTGTCTTATCT -> GGTTCTCCTGTCTTATCTA
AGTAACTTGTAAATCTTCG -> GTAACTTGTAAATCTTCGA
AGTAAGGTTCTCCTGTCTT -> GTAAGGTTCTCCTGTCTTA
AGTAATTGGTTTTAATCTG -> GTAATTGGTTTTAATCTGG
AGTAATTGTGTATTTGCCC -> GTAATTGTGTATTTGCCCA
AGTACAAGAAGCTGCGATC -> GTACAAGAAGCTGCGATCC
AGTAGGTCCCCCCTTGTTG -> GTAGGTCCCCCCTTGTTGG
AGTAGTGGAGTGTAGGATG -> GTAGTGGAGTGTAGGATGC
AGTATACGAGCATCTGGAA -> GTATACGAGCATCTGGAAG
AGTATGGCCGGTTGTGGCA -> GTATGGCCGGTTGTGGCAG
AGTCAATGATCAAGGCTTA -> GTCAATGATCAAGGCTTAC
AGTCATGAGCGTGCGGAGA -> GTCATGAGCGTGCGGAGAT
AGTCATTACAAATTAAGAA -> GTCATTACAAATTAAGAAC
AGTCCTACGACACCTTTCA -> GTCCTACGACACCTTTCAA
AGTCTTGATTAGCCGCAAG -> GTCTTGATTAGCCGCAAGC
AGTCTTTAATCACGGGTTA -> GTCTTTAATCACGGGTTAA
AGTGACTCGCCGCGGACTG -> GTGACTCGCCGCGGACTGT
AGTGAGTTTGGACAACCAA -> GTGAGTTTGGACAACCAAT
AGTGCAGAGTTAAATGCGG -> GTGCAGAGTTAAATGCGGG
AGTGCTGGTACGTTGCTCC -> GTGCTGGTACGTTGCTCCG
AGTGGAGTGTAGGATGCGT -> GTGGAGTGTAGGATGCGTG
AGTGGGGTATTTAATGAGG -> GTGGGGTATTTAATGAGGG
AGTGTAGGATGCGTGACCA -> GTGTAGGATGCGTGACCAA
AGTGTATCGTCGGCTGTTT -> GTGTATCGTCGGCTGTTTG
AGTGTGGGTGCGGTTCGAT -> GTGTGGGTGCGGTTCGATA
AGTGTTTGCTTAGCGCTCG -> GTGTTTGCTTAGCGCTCGC
AGTGTTTTATTTGCGGCCG -> GTGTTTTATTTGCGGCCGT
AGTTAAATGCGGGCCCGCT -> GTTAAATGCGGGCCCGCTG
AGTTAGAGTTTCAACCCGG -> GTTAGAGTTTCAACCCGGC
AGTTCTTACTGTCTCCATC -> GTTCTTACTGTCTCCATCC
AGTTGATTCGACTTTCCAT -> GTTGATTCGACTTTCCATC
AGTTTCAACCCGGCAAATC -> GTTTCAACCCGGCAAATCT
AGTTTGGACAACCAATCGC -> GTTTGGACAACCAATCGCA
ATAAATAGATGAAATCTCT -> TAAATAGATGAAATCTCTA
ATAACGGATTTATAGGAAA -> TAACGGATTTATAGGAAAA
ATAATCTTTGGTATAGGTG -> TAATCTTTGGTATAGGTGA
ATAATGGCAGCCATGTTGG -> TAATGGCAGCCATGTTGGC
ATAATTTCCGGGACTTCCA -> TAATTTCCGGGACTTCCAG
ATACACTGTGCGTAAAGAA -> TACACTGTGCGTAAAGAAA
ATACATTAACACAAAATAT -> TACATTAACACAAAATATC
ATACATTCTTGTAGTCATT -> TACATTCTTGTAGTCATTA
ATACCCAAGGGTGTCTAGG -> TACCCAAGGGTGTCTAGGG
ATACGAGCATCTGGAAGGG -> TACGAGCATCTGGAAGGGA
ATACGATGGGATTATAGAT -> TACGATGGGATTATAGATA
ATACTAGAAGGCCTACAGA -> TACTAGAAGGCCTACAGAG
ATAGAAACATACCCAAGGG -> TAGAAACATACCCAAGGGT
ATAGAATTGTTCACGTGGT -> TAGAATTGTTCACGTGGTG
ATAGATAGCAGTCAATGAT -> TAGATAGCAGTCAATGATC
ATAGATGAAATCTCTAGGT -> TAGATGAAATCTCTAGGTA
ATAGCAGTCAATGATCAAG -> TAGCAGTCAATGATCAAGG
ATAGGAAAACGCATGACTT -> TAGGAAAACGCATGACTTT
ATAGGCAGTGTTTTATTTG -> TAGGCAGTGTTTTATTTGC
ATAGGCCCCACGGGTAGCA -> TAGGCCCCACGGGTAGCAT
ATAGGCCCTCGACACTTAC -> TAGGCCCTCGACACTTACG
ATAGGTCTCAATCTCATGG -> TAGGTCTCAATCTCATGGT
ATAGGTGAAGGAAGATATA -> TAGGTGAAGGAAGATATAT
ATATAAATAGATGAAATCT -> TATAAATAGATGAAATCTC
ATATAGAATTGTTCACGTG -> TATAGAATTGTTCACGTGG
ATATATAAATAGATGAAAT -> TATATAAATAGATGAAATC
ATATATAGAATTGTTCACG -> TATATAGAATTGTTCACGT
ATATCGATTCTGTACTAAT -> TATCGATTCTGTACTAATA
ATATCTGATCCCGTGACAT -> TATCTGATCCCGTGACATC
ATATGAACCGTGCCACGTT -> TATGAACCGTGCCACGTTC
ATATTTGAAAATGTGACTG -> TATTTGAAAATGTGACTGA
ATATTTTGTCACCCATCAG -> TATTTTGTCACCCATCAGT
ATCAAAGACAACAGAACTG -> TCAAAGACAACAGAACTGT
ATCAAAGGAAGCGGGATTC -> TCAAAGGAAGCGGGATTCT
ATCAAGGCTTACGTAGCCG -> TCAAGGCTTACGTAGCCGC
ATCAATATTTGAAAATGTG -> TCAATATTTGAAAATGTGA
ATCACCAGCCACGTTCGAC -> TCACCAGCCACGTTCGACC
ATCACGGGTTAAGACCGCA -> TCACGGGTTAAGACCGCAC
ATCAGTCATGAGCGTGCGG -> TCAGTCATGAGCGTGCGGA
ATCCACGGCTGAGCCTCGG -> TCCACGGCTGAGCCTCGGC
ATCCAGGTGCACTCAAGTA -> TCCAGGTGCACTCAAGTAG
ATCCAGTGAGTTTGGACAA -> TCCAGTGAGTTTGGACAAC
ATCCATACGATGGGATTAT -> TCCATACGATGGGATTATA
ATCCATCAATATTTGAAAA -> TCCATCAATATTTGAAAAT
ATCCCCGCAAGGGTACGTT -> TCCCCGCAAGGGTACGTTT
ATCCCGTGACATCCGGCTA -> TCCCGTGACATCCGGCTAT
ATCCGCGGAGGTACGCCTG -> TCCGCGGAGGTACGCCTGA
ATCCGGCTATTGCAGTCTT -> TCCGGCTATTGCAGTCTTG
ATCCGGGTTCCAGCTAACT -> TCCGGGTTCCAGCTAACTT
ATCCGTTATTTCGAAGCTG -> TCCGTTATTTCGAAGCTGA
ATCCTAGCCCGTAGCGTTT -> TCCTAGCCCGTAGCGTTTG
ATCGAATGCGATTGTGAGG -> TCGAATGCGATTGTGAGGT
ATCGATCGATTAGAATGTC -> TCGATCGATTAGAATGTCT
ATCGATTAGAATGTCTCAC -> TCGATTAGAATGTCTCACC
ATCGATTCACGTACTGGTC -> TCGATTCACGTACTGGTCA
ATCGATTCTGTACTAATAA -> TCGATTCTGTACTAATAAT
ATCGCATTGTATATATAGA -> TCGCATTGTATATATAGAA
ATCGCGGGGTCCAACTTTG -> TCGCGGGGTCCAACTTTGT
ATCGCTCAACCCGTGGACG -> TCGCTCAACCCGTGGACGC
ATCGGGGAGCCACCAGATG -> TCGGGGAGCCACCAGATGG
ATCGTCGGCTGTTTGCCAA -> TCGTCGGCTGTTTGCCAAG
ATCGTTGGAAAGCCCGGTT -> TCGTTGGAAAGCCCGGTTT
ATCTAATAGGTCTCAATCT -> TCTAATAGGTCTCAATCTC
ATCTACGCGAGTTCTTACT -> TCTACGCGAGTTCTTACTG
ATCTAGGAAAATTGATAGA -> TCTAGGAAAATTGATAGAA
ATCTAGTGGGGTATTTAAT -> TCTAGTGGGGTATTTAATG
ATCTATTGCAGTATGGCCG -> TCTATTGCAGTATGGCCGG
ATCTCAGACCCAAGGGAAA -> TCTCAGACCCAAGGGAAAA
ATCTCATGGTACCGTAGTT -> TCTCATGGTACCGTAGTTG
ATCTCTAAATAATGGCAGC -> TCTCTAAATAATGGCAGCC
ATCTCTAGGTACTTTACGC -> TCTCTAGGTACTTTACGCT
ATCTGATCCCGTGACATCC -> TCTGATCCCGTGACATCCG
ATCTGGAAGGGATACATTC -> TCTGGAAGGGATACATTCT
ATCTGGTTCAAACCTATAG -> TCTGGTTCAAACCTATAGG
ATCTTCGAAGCTAATCTCT -> TCTTCGAAGCTAATCTCTA
ATCTTCGATAGGCCCCACG -> TCTTCGATAGGCCCCACGG
ATCTTTAGACAGTGCAGAG -> TCTTTAGACAGTGCAGAGT
ATCTTTGGTATAGGTGAAG -> TCTTTGGTATAGGTGAAGG
ATGAAATCTCTAGGTACTT -> TGAAATCTCTAGGTACTTT
ATGAACCGTGCCACGTTCG -> TGAACCGTGCCACGTTCGA
ATGACTACTTTGAACCTTT -> TGACTACTTTGAACCTTTC
ATGACTTTATCACCAGCCA -> TGACTTTATCACCAGCCAC
ATGAGCCTACGAGCTCTGT -> TGAGCCTACGAGCTCTGTA
ATGAGCGTGCGGAGATCCA -> TGAGCGTGCGGAGATCCAG
ATGAGGGATATCTGATCCC -> TGAGGGATATCTGATCCCG
ATGAGTACAAGAAGCTGCG -> TGAGTACAAGAAGCTGCGA
ATGATCAAGGCTTACGTAG -> TGATCAAGGCTTACGTAGC
ATGCCTGGCATTGCATCCA -> TGCCTGGCATTGCATCCAC
ATGCGATTGTGAGGTCTTT -> TGCGATTGTGAGGTCTTTT
ATGCGGGCCCGCTGTGTTG -> TGCGGGCCCGCTGTGTTGA
ATGCGTGACCAATGTCTTA -> TGCGTGACCAATGTCTTAA
ATGGACCTGTCTTGCTCGA -> TGGACCTGTCTTGCTCGAC
ATGGCAGCCATGTTGGCTT -> TGGCAGCCATGTTGGCTTG
ATGGCCGGTTGTGGCAGCC -> TGGCCGGTTGTGGCAGCCA
ATGGCGCGGACACTTATAA -> TGGCGCGGACACTTATAAC
ATGGCTAATCCTAGCCCGT -> TGGCTAATCCTAGCCCGTA
ATGGGATTATAGATAGCAG -> TGGGATTATAGATAGCAGT
ATGGTACCGTAGTTGATTC -> TGGTACCGTAGTTGATTCG
ATGTCGCAAGGGAGAATGA -> TGTCGCAAGGGAGAATGAG
ATGTCTCACCTAATATGAA -> TGTCTCACCTAATATGAAC
ATGTCTTAAACGTAAACAG -> TGTCTTAAACGTAAACAGC
ATGTGACTGACCGCCACGT -> TGTGACTGACCGCCACGTT
ATGTTGGCTTGTCTGGACA -> TGTTGGCTTGTCTGGACAG
ATTAACACAAAATATCGAT -> TTAACACAAAATATCGATT
ATTAAGAACCGAGTAACTT -> TTAAGAACCGAGTAACTTG
ATTACAAATTAAGAACCGA -> TTACAAATTAAGAACCGAG
ATTACCTGTGTCGCGCCAG -> TTACCTGTGTCGCGCCAGT
ATTAGAATGTCTCACCTAA -> TTAGAATGTCTCACCTAAT
ATTAGCCGCAAGCCTCAAG -> TTAGCCGCAAGCCTCAAGG
ATTATAGATAGCAGTCAAT -> TTATAGATAGCAGTCAATG
ATTATATTTTGTCACCCAT -> TTATATTTTGTCACCCATC
ATTATTACCTGTGTCGCGC -> TTATTACCTGTGTCGCGCC
ATTCACGTACTGGTCACTG -> TTCACGTACTGGTCACTGC
ATTCGACTTTCCATCCGGG -> TTCGACTTTCCATCCGGGT
ATTCGTCCCTGCCAGTCCT -> TTCGTCCCTGCCAGTCCTA
ATTCGTCCGCCCCATTTTT -> TTCGTCCGCCCCATTTTTT
ATTCTCCAAGGCTCCTCCA -> TTCTCCAAGGCTCCTCCAG
ATTCTGTACTAATAATTTC -> TTCTGTACTAATAATTTCC
ATTCTGTGCTACGACCCTC -> TTCTGTGCTACGACCCTCC
ATTCTTGTAGTCATTACAA -> TTCTTGTAGTCATTACAAA
ATTGATAGAAACATACCCA -> TTGATAGAAACATACCCAA
ATTGCAGTATGGCCGGTTG -> TTGCAGTATGGCCGGTTGT
ATTGCAGTCTTGATTAGCC -> TTGCAGTCTTGATTAGCCG
ATTGCATCCACGGCTGAGC -> TTGCATCCACGGCTGAGCC
ATTGGAGAGGGTTCCGTCT -> TTGGAGAGGGTTCCGTCTC
ATTGGTTTTAATCTGGTTC -> TTGGTTTTAATCTGGTTCA
ATTGTATATATAGAATTGT -> TTGTATATATAGAATTGTT
ATTGTGAGGTCTTTTAGTG -> TTGTGAGGTCTTTTAGTGA
ATTGTGTATTTGCCCATCT -> TTGTGTATTTGCCCATCTA
ATTGTGTTCCCTGTCCACG -> TTGTGTTCCCTGTCCACGA
ATTGTTCACGTGGTGGCCA -> TTGTTCACGTGGTGGCCAC
ATTTAATGAGGGATATCTG -> TTTAATGAGGGATATCTGA
ATTTATAGGAAAACGCATG -> TTTATAGGAAAACGCATGA
ATTTCCGGGACTTCCAGTC -> TTTCCGGGACTTCCAGTCT
ATTTCGAAGCTGATTATAT -> TTTCGAAGCTGATTATATT
ATTTGAAAATGTGACTGAC -> TTTGAAAATGTGACTGACC
ATTTGCCCATCTAGTGGGG -> TTTGCCCATCTAGTGGGGT
ATTTGCGGCCGTCGTAGAG -> TTTGCGGCCGTCGTAGAGC
ATTTGGTAAGACTCCATCC -> TTTGGTAAGACTCCATCCA
ATTTTGATCGATCGATTAG -> TTTTGATCGATCGATTAGA
ATTTTGTCACCCATCAGTC -> TTTTGTCACCCATCAGTCA
ATTTTTTTGGGTAGTAATT -> TTTTTTTGGGTAGTAATTG
CAAAACCGCGGCAGGAACA -> AAAACCGCGGCAGGAACAA
CAAAATATCGATTCTGTAC -> AAAATATCGATTCTGTACT
CAAACCTATAGGCAGTGTT -> AAACCTATAGGCAGTGTTT
CAAACGTAGTGTTTGCTTA -> AAACGTAGTGTTTGCTTAG
CAAAGACAACAGAACTGTA -> AAAGACAACAGAACTGTAT
CAAAGGAAGCGGGATTCTG -> AAAGGAAGCGGGATTCTGT
CAAATCTCAGACCCAAGGG -> AAATCTCAGACCCAAGGGA
CAAATTAAGAACCGAGTAA -> AAATTAAGAACCGAGTAAC
CAACAGAACTGTATCTAAT -> AACAGAACTGTATCTAATA
CAACAGAACTGTATCTAGG -> AACAGAACTGTATCTAGGA
CAACAGAACTGTATCTATT -> AACAGAACTGTATCTATTG
CAACAGAACTGTATCTTCG -> AACAGAACTGTATCTTCGA
CAACCAATCGCATTGTATA -> AACCAATCGCATTGTATAT
CAACCCGGCAAATCTCAGA -> AACCCGGCAAATCTCAGAC
CAACCCGTGGACGCCGATC -> AACCCGTGGACGCCGATCT
CAACTTTGTTAACTAGGAA -> AACTTTGTTAACTAGGAAA
CAAGAAGCTGCGATCCAGG -> AAGAAGCTGCGATCCAGGT
CAAGACAACAGAACTGTAT -> AAGACAACAGAACTGTATC
CAAGCCTCAAGGCTACAAT -> AAGCCTCAAGGCTACAATA
CAAGGCTACAATACTAGAA -> AAGGCTACAATACTAGAAG
CAAGGCTCCTCCAGCCCGG -> AAGGCTCCTCCAGCCCGGG
CAAGGCTTACGTAGCCGCT -> AAGGCTTACGTAGCCGCTT
CAAGGGAAAAAATCGAATG -> AAGGGAAAAAATCGAATGC
CAAGGGAGAATGAGTACAA -> AAGGGAGAATGAGTACAAG
CAAGGGTACGTTTTATTAT -> AAGGGTACGTTTTATTATT
CAAGGGTGTCTAGGGCACG -> AAGGGTGTCTAGGGCACGC
CAAGGTACAGTAATTGGTT -> AAGGTACAGTAATTGGTTT
CAAGTAGGTCCCCCCTTGT -> AAGTAGGTCCCCCCTTGTT
CAAGTATACGAGCATCTGG -> AAGTATACGAGCATCTGGA
CAATACTAGAAGGCCTACA -> AATACTAGAAGGCCTACAG
CAATATTTGAAAATGTGAC -> AATATTTGAAAATGTGACT
CAATCCGCGGAGGTACGCC -> AATCCGCGGAGGTACGCCT
CAATCGCATTGTATATATA -> AATCGCATTGTATATATAG
CAATCTCATGGTACCGTAG -> AATCTCATGGTACCGTAGT
CAATGATCAAGGCTTACGT -> AATGATCAAGGCTTACGTA
CAATGTCTTAAACGTAAAC -> AATGTCTTAAACGTAAACA
CACAAAATATCGATTCTGT -> ACAAAATATCGATTCTGTA
CACCAGATGGCGCGGACAC -> ACCAGATGGCGCGGACACT
CACCAGCCACGTTCGACCG -> ACCAGCCACGTTCGACCGA
CACCCATCAGTCATGAGCG -> ACCCATCAGTCATGAGCGT
CACCTAACAAAACCGCGGC -> ACCTAACAAAACCGCGGCA
CACCTAATATGAACCGTGC -> ACCTAATATGAACCGTGCC
CACCTTTCAAACGTAGTGT -> ACCTTTCAAACGTAGTGTT
CACGATAGGCCCTCGACAC -> ACGATAGGCCCTCGACACT
CACGCCCATTCTCCAAGGC -> ACGCCCATTCTCCAAGGCT
CACGGCTGAGCCTCGGCTG -> ACGGCTGAGCCTCGGCTGT
CACGGGTAGCATTTGGTAA -> ACGGGTAGCATTTGGTAAG
CACGGGTTAAGACCGCACT -> ACGGGTTAAGACCGCACTA
CACGTACTGGTCACTGCCC -> ACGTACTGGTCACTGCCCC
CACGTGGTGGCCACGTTCG -> ACGTGGTGGCCACGTTCGA
CACGTTCGACCGACCCAGC -> ACGTTCGACCGACCCAGCT
CACGTTCGACCGACCCCTT -> ACGTTCGACCGACCCCTTG
CACGTTCGACCGACCCGGT -> ACGTTCGACCGACCCGGTC
CACGTTCGACCGACCCTAC -> ACGTTCGACCGACCCTACC
CACTAGCTTTAAGAAAACT -> ACTAGCTTTAAGAAAACTA
CACTATCAAAGGAAGCGGG -> ACTATCAAAGGAAGCGGGA
CACTCAAGTAGGTCCCCCC -> ACTCAAGTAGGTCCCCCCT
CACTGCCCCATGAGCCTAC -> ACTGCCCCATGAGCCTACG
CACTGTGCGTAAAGAAAGT -> ACTGTGCGTAAAGAAAGTG
CACTTACGTGATCGTTGGA -> ACTTACGTGATCGTTGGAA
CACTTATAACGGATTTATA -> ACTTATAACGGATTTATAG
CAGAACTGTATCTAATAGG -> AGAACTGTATCTAATAGGT
CAGAACTGTATCTAGGAAA -> AGAACTGTATCTAGGAAAA
CAGAACTGTATCTATTGCA -> AGAACTGTATCTATTGCAG
CAGAACTGTATCTTCGAAG -> AGAACTGTATCTTCGAAGC
CAGACAACAGAACTGTATC -> AGACAACAGAACTGTATCT
CAGACCCAAGGGAAAAAAT -> AGACCCAAGGGAAAAAATC
CAGAGACGTAGGGCATTTT -> AGAGACGTAGGGCATTTTG
CAGAGTTAAATGCGGGCCC -> AGAGTTAAATGCGGGCCCG
CAGATGGCGCGGACACTTA -> AGATGGCGCGGACACTTAT
CAGCCACGTTCGACCGACC -> AGCCACGTTCGACCGACCC
CAGCCAGGGAAAGCGCCTC -> AGCCAGGGAAAGCGCCTCC
CAGCCATGTTGGCTTGTCT -> AGCCATGTTGGCTTGTCTG
CAGCCCGGGCGTTTGCATT -> AGCCCGGGCGTTTGCATTC
CAGCCTCCCACTAGCTTTA -> AGCCTCCCACTAGCTTTAA
CAGCGTCGTTCGGAGATCG -> AGCGTCGTTCGGAGATCGG
CAGCTAACTTGTTAGCGTC -> AGCTAACTTGTTAGCGTCG
CAGCTACTGTCAAGACAAC -> AGCTACTGTCAAGACAACA
CAGGAACAATCCGCGGAGG -> AGGAACAATCCGCGGAGGT
CAGGGAAAGCGCCTCCGCC -> AGGGAAAGCGCCTCCGCCT
CAGGTGCACTCAAGTAGGT -> AGGTGCACTCAAGTAGGTC
CAGTAATTGGTTTTAATCT -> AGTAATTGGTTTTAATCTG
CAGTAGTGGAGTGTAGGAT -> AGTAGTGGAGTGTAGGATG
CAGTATGGCCGGTTGTGGC -> AGTATGGCCGGTTGTGGCA
CAGTCAATGATCAAGGCTT -> AGTCAATGATCAAGGCTTA
CAGTCATGAGCGTGCGGAG -> AGTCATGAGCGTGCGGAGA
CAGTCCTACGACACCTTTC -> AGTCCTACGACACCTTTCA
CAGTCTTGATTAGCCGCAA -> AGTCTTGATTAGCCGCAAG
CAGTCTTTAATCACGGGTT -> AGTCTTTAATCACGGGTTA
CAGTGAGTTTGGACAACCA -> AGTGAGTTTGGACAACCAA
CAGTGCAGAGTTAAATGCG -> AGTGCAGAGTTAAATGCGG
CAGTGTTTTATTTGCGGCC -> AGTGTTTTATTTGCGGCCG
CAGTTAGAGTTTCAACCCG -> AGTTAGAGTTTCAACCCGG
CATACCCAAGGGTGTCTAG -> ATACCCAAGGGTGTCTAGG
CATACGATGGGATTATAGA -> ATACGATGGGATTATAGAT
CATCAATATTTGAAAATGT -> ATCAATATTTGAAAATGTG
CATCAGTCATGAGCGTGCG -> ATCAGTCATGAGCGTGCGG
CATCCACGGCTGAGCCTCG -> ATCCACGGCTGAGCCTCGG
CATCCATACGATGGGATTA -> ATCCATACGATGGGATTAT
CATCCATCAATATTTGAAA -> ATCCATCAATATTTGAAAA
CATCCGGCTATTGCAGTCT -> ATCCGGCTATTGCAGTCTT
CATCCGGGTTCCAGCTAAC -> ATCCGGGTTCCAGCTAACT
CATCCGTTATTTCGAAGCT -> ATCCGTTATTTCGAAGCTG
CATCTAGTGGGGTATTTAA -> ATCTAGTGGGGTATTTAAT
CATCTGGAAGGGATACATT -> ATCTGGAAGGGATACATTC
CATGACTACTTTGAACCTT -> ATGACTACTTTGAACCTTT
CATGACTTTATCACCAGCC -> ATGACTTTATCACCAGCCA
CATGAGCCTACGAGCTCTG -> ATGAGCCTACGAGCTCTGT
CATGAGCGTGCGGAGATCC -> ATGAGCGTGCGGAGATCCA
CATGGACCTGTCTTGCTCG -> ATGGACCTGTCTTGCTCGA
CATGGTACCGTAGTTGATT -> ATGGTACCGTAGTTGATTC
CATGTTGGCTTGTCTGGAC -> ATGTTGGCTTGTCTGGACA
CATTAACACAAAATATCGA -> ATTAACACAAAATATCGAT
CATTACAAATTAAGAACCG -> ATTACAAATTAAGAACCGA
CATTCGTCCCTGCCAGTCC -> ATTCGTCCCTGCCAGTCCT
CATTCTCCAAGGCTCCTCC -> ATTCTCCAAGGCTCCTCCA
CATTCTTGTAGTCATTACA -> ATTCTTGTAGTCATTACAA
CATTGCATCCACGGCTGAG -> ATTGCATCCACGGCTGAGC
CATTGGAGAGGGTTCCGTC -> ATTGGAGAGGGTTCCGTCT
CATTGTATATATAGAATTG -> ATTGTATATATAGAATTGT
CATTTGGTAAGACTCCATC -> ATTTGGTAAGACTCCATCC
CATTTTGATCGATCGATTA -> ATTTTGATCGATCGATTAG
CATTTTTTTGGGTAGTAAT -> ATTTTTTTGGGTAGTAATT
CCAACTTTGTTAACTAGGA -> CAACTTTGTTAACTAGGAA
CCAAGGCTCCTCCAGCCCG -> CAAGGCTCCTCCAGCCCGG
CCAAGGGAAAAAATCGAAT -> CAAGGGAAAAAATCGAATG
CCAAGGGTGTCTAGGGCAC -> CAAGGGTGTCTAGGGCACG
CCAAGGTACAGTAATTGGT -> CAAGGTACAGTAATTGGTT
CCAATCGCATTGTATATAT -> CAATCGCATTGTATATATA
CCAATGTCTTAAACGTAAA -> CAATGTCTTAAACGTAAAC
CCACCAGATGGCGCGGACA -> CACCAGATGGCGCGGACAC
CCACCTAACAAAACCGCGG -> CACCTAACAAAACCGCGGC
CCACGATAGGCCCTCGACA -> CACGATAGGCCCTCGACAC
CCACGGCTGAGCCTCGGCT -> CACGGCTGAGCCTCGGCTG
CCACGGGTAGCATTTGGTA -> CACGGGTAGCATTTGGTAA
CCACGTTCGACCGACCCAG -> CACGTTCGACCGACCCAGC
CCACGTTCGACCGACCCCT -> CACGTTCGACCGACCCCTT
CCACGTTCGACCGACCCGG -> CACGTTCGACCGACCCGGT
CCACGTTCGACCGACCCTA -> CACGTTCGACCGACCCTAC
CCACTAGCTTTAAGAAAAC -> CACTAGCTTTAAGAAAACT
CCAGATGGCGCGGACACTT -> CAGATGGCGCGGACACTTA
CCAGCCACGTTCGACCGAC -> CAGCCACGTTCGACCGACC
CCAGCCCGGGCGTTTGCAT -> CAGCCCGGGCGTTTGCATT
CCAGCTAACTTGTTAGCGT -> CAGCTAACTTGTTAGCGTC
CCAGCTACTGTCAAGACAA -> CAGCTACTGTCAAGACAAC
CCAGGGAAAGCGCCTCCGC -> CAGGGAAAGCGCCTCCGCC
CCAGGTGCACTCAAGTAGG -> CAGGTGCACTCAAGTAGGT
CCAGTAGTGGAGTGTAGGA -> CAGTAGTGGAGTGTAGGAT
CCAGTCCTACGACACCTTT -> CAGTCCTACGACACCTTTC
CCAGTCTTTAATCACGGGT -> CAGTCTTTAATCACGGGTT
CCAGTGAGTTTGGACAACC -> CAGTGAGTTTGGACAACCA
CCATACGATGGGATTATAG -> CATACGATGGGATTATAGA
CCATCAATATTTGAAAATG -> CATCAATATTTGAAAATGT
CCATCAGTCATGAGCGTGC -> CATCAGTCATGAGCGTGCG
CCATCCATACGATGGGATT -> CATCCATACGATGGGATTA
CCATCCATCAATATTTGAA -> CATCCATCAATATTTGAAA
CCATCCGGGTTCCAGCTAA -> CATCCGGGTTCCAGCTAAC
CCATCCGTTATTTCGAAGC -> CATCCGTTATTTCGAAGCT
CCATCTAGTGGGGTATTTA -> CATCTAGTGGGGTATTTAA
CCATGAGCCTACGAGCTCT -> CATGAGCCTACGAGCTCTG
CCATGTTGGCTTGTCTGGA -> CATGTTGGCTTGTCTGGAC
CCATTCTCCAAGGCTCCTC -> CATTCTCCAAGGCTCCTCC
CCATTTTTTTGGGTAGTAA -> CATTTTTTTGGGTAGTAAT
CCCAAGGGAAAAAATCGAA -> CCAAGGGAAAAAATCGAAT
CCCAAGGGTGTCTAGGGCA -> CCAAGGGTGTCTAGGGCAC
CCCACCTAACAAAACCGCG -> CCACCTAACAAAACCGCGG
CCCACGGGTAGCATTTGGT -> CCACGGGTAGCATTTGGTA
CCCACTAGCTTTAAGAAAA -> CCACTAGCTTTAAGAAAAC
CCCAGCTACTGTCAAGACA -> CCAGCTACTGTCAAGACAA
CCCATCAGTCATGAGCGTG -> CCATCAGTCATGAGCGTGC
CCCATCTAGTGGGGTATTT -> CCATCTAGTGGGGTATTTA
CCCATGAGCCTACGAGCTC -> CCATGAGCCTACGAGCTCT
CCCATTCTCCAAGGCTCCT -> CCATTCTCCAAGGCTCCTC
CCCATTTTTTTGGGTAGTA -> CCATTTTTTTGGGTAGTAA
CCCCACCTAACAAAACCGC -> CCCACCTAACAAAACCGCG
CCCCACGGGTAGCATTTGG -> CCCACGGGTAGCATTTGGT
CCCCATGAGCCTACGAGCT -> CCCATGAGCCTACGAGCTC
CCCCATTTTTTTGGGTAGT -> CCCATTTTTTTGGGTAGTA
CCCCCCTTGTTGGGAACCA -> CCCCCTTGTTGGGAACCAT
CCCCCTTGTTGGGAACCAT -> CCCCTTGTTGGGAACCATC
CCCCGCAAGGGTACGTTTT -> CCCGCAAGGGTACGTTTTA
CCCCTTGTGCGGTCAGACA -> CCCTTGTGCGGTCAGACAA
CCCCTTGTTGGGAACCATC -> CCCTTGTTGGGAACCATCC
CCCCTTTAGGAGTAAGGTT -> CCCTTTAGGAGTAAGGTTC
CCCGAGGGAATACATTAAC -> CCGAGGGAATACATTAACA
CCCGCAAGGGTACGTTTTA -> CCGCAAGGGTACGTTTTAT
CCCGCTGTGTTGATTCGTC -> CCGCTGTGTTGATTCGTCC
CCCGGCAAATCTCAGACCC -> CCGGCAAATCTCAGACCCA
CCCGGGCGTTTGCATTCGT -> CCGGGCGTTTGCATTCGTC
CCCGGTCGTATCAAAGACA -> CCGGTCGTATCAAAGACAA
CCCGGTTTGTCTGATGCCT -> CCGGTTTGTCTGATGCCTG
CCCGTAGCGTTTGGTCATT -> CCGTAGCGTTTGGTCATTG
CCCGTGACATCCGGCTATT -> CCGTGACATCCGGCTATTG
CCCGTGGACGCCGATCTTT -> CCGTGGACGCCGATCTTTA
CCCTACCTTGGAGGAGACA -> CCTACCTTGGAGGAGACAA
CCCTCCCCACCTAACAAAA -> CCTCCCCACCTAACAAAAC
CCCTCGACACTTACGTGAT -> CCTCGACACTTACGTGATC
CCCTGCCAGTCCTACGACA -> CCTGCCAGTCCTACGACAC
CCCTGTCCACGATAGGCCC -> CCTGTCCACGATAGGCCCT
CCCTTGTGCGGTCAGACAA -> CCTTGTGCGGTCAGACAAC
CCCTTGTTGGGAACCATCC -> CCTTGTTGGGAACCATCCG
CCCTTTAGGAGTAAGGTTC -> CCTTTAGGAGTAAGGTTCT
CCGAAATCGATTCACGTAC -> CGAAATCGATTCACGTACT
CCGACCCAGCTACTGTCAA -> CGACCCAGCTACTGTCAAG
CCGACCCCTTGTGCGGTCA -> CGACCCCTTGTGCGGTCAG
CCGACCCGGTCGTATCAAA -> CGACCCGGTCGTATCAAAG
CCGACCCTACCTTGGAGGA -> CGACCCTACCTTGGAGGAG
CCGAGGGAATACATTAACA -> CGAGGGAATACATTAACAC
CCGAGTAACTTGTAAATCT -> CGAGTAACTTGTAAATCTT
CCGATCTTTAGACAGTGCA -> CGATCTTTAGACAGTGCAG
CCGCAAGCCTCAAGGCTAC -> CGCAAGCCTCAAGGCTACA
CCGCAAGGGTACGTTTTAT -> CGCAAGGGTACGTTTTATT
CCGCACTATCAAAGGAAGC -> CGCACTATCAAAGGAAGCG
CCGCCACGTTCGACCGACC -> CGCCACGTTCGACCGACCC
CCGCCCCATTTTTTTGGGT -> CGCCCCATTTTTTTGGGTA
CCGCCTAAGGCCCCTTTAG -> CGCCTAAGGCCCCTTTAGG
CCGCGCTATCGCGGGGTCC -> CGCGCTATCGCGGGGTCCA
CCGCGGACTGTGGTGTAGA -> CGCGGACTGTGGTGTAGAA
CCGCGGAGGTACGCCTGAT -> CGCGGAGGTACGCCTGATC
CCGCGGCAGGAACAATCCG -> CGCGGCAGGAACAATCCGC
CCGCTGTGTTGATTCGTCC -> CGCTGTGTTGATTCGTCCG
CCGCTTACCGCGCTATCGC -> CGCTTACCGCGCTATCGCG
CCGGCAAATCTCAGACCCA -> CGGCAAATCTCAGACCCAA
CCGGCTATTGCAGTCTTGA -> CGGCTATTGCAGTCTTGAT
CCGGGACTTCCAGTCTTTA -> CGGGACTTCCAGTCTTTAA
CCGGGCGTTTGCATTCGTC -> CGGGCGTTTGCATTCGTCC
CCGGGTTCCAGCTAACTTG -> CGGGTTCCAGCTAACTTGT
CCGGTCGTATCAAAGACAA -> CGGTCGTATCAAAGACAAC
CCGGTTGTGGCAGCCAGGG -> CGGTTGTGGCAGCCAGGGA
CCGGTTTGTCTGATGCCTG -> CGGTTTGTCTGATGCCTGG
CCGTAGCGTTTGGTCATTG -> CGTAGCGTTTGGTCATTGG
CCGTAGTTGATTCGACTTT -> CGTAGTTGATTCGACTTTC
CCGTCGTAGAGCGTCCCGA -> CGTCGTAGAGCGTCCCGAG
CCGTCTCTGACATGACTAC -> CGTCTCTGACATGACTACT
CCGTGACATCCGGCTATTG -> CGTGACATCCGGCTATTGC
CCGTGCCACGTTCGACCGA -> CGTGCCACGTTCGACCGAC
CCGTGGACGCCGATCTTTA -> CGTGGACGCCGATCTTTAG
CCGTTATTTCGAAGCTGAT -> CGTTATTTCGAAGCTGATT
CCTAACAAAACCGCGGCAG -> CTAACAAAACCGCGGCAGG
CCTAAGGCCCCTTTAGGAG -> CTAAGGCCCCTTTAGGAGT
CCTAATATGAACCGTGCCA -> CTAATATGAACCGTGCCAC
CCTACAGAGACGTAGGGCA -> CTACAGAGACGTAGGGCAT
CCTACCTTGGAGGAGACAA -> CTACCTTGGAGGAGACAAC
CCTACGACACCTTTCAAAC -> CTACGACACCTTTCAAACG
CCTACGAGCTCTGTATGGC -> CTACGAGCTCTGTATGGCT
CCTAGCCCGTAGCGTTTGG -> CTAGCCCGTAGCGTTTGGT
CCTATAGGCAGTGTTTTAT -> CTATAGGCAGTGTTTTATT
CCTCAAGGCTACAATACTA -> CTCAAGGCTACAATACTAG
CCTCCAGCCCGGGCGTTTG -> CTCCAGCCCGGGCGTTTGC
CCTCCCACTAGCTTTAAGA -> CTCCCACTAGCTTTAAGAA
CCTCCCCACCTAACAAAAC -> CTCCCCACCTAACAAAACC
CCTCCGCCTAAGGCCCCTT -> CTCCGCCTAAGGCCCCTTT
CCTCGACACTTACGTGATC -> CTCGACACTTACGTGATCG
CCTCGGCTGTGGCTACGTG -> CTCGGCTGTGGCTACGTGC
CCTGATCCCCGCAAGGGTA -> CTGATCCCCGCAAGGGTAC
CCTGCCAGTCCTACGACAC -> CTGCCAGTCCTACGACACC
CCTGGCATTGCATCCACGG -> CTGGCATTGCATCCACGGC
CCTGTCCACGATAGGCCCT -> CTGTCCACGATAGGCCCTC
CCTGTCTTATCTACGCGAG -> CTGTCTTATCTACGCGAGT
CCTGTCTTGCTCGACAGCG -> CTGTCTTGCTCGACAGCGT
CCTGTGTCGCGCCAGTAGT -> CTGTGTCGCGCCAGTAGTG
CCTTGGAGGAGACAACAGA -> CTTGGAGGAGACAACAGAA
CCTTGTGCGGTCAGACAAC -> CTTGTGCGGTCAGACAACA
CCTTGTTGGGAACCATCCG -> CTTGTTGGGAACCATCCGT
CCTTTAGGAGTAAGGTTCT -> CTTTAGGAGTAAGGTTCTC
CCTTTCAAACGTAGTGTTT -> CTTTCAAACGTAGTGTTTG
CCTTTCATGGACCTGTCTT -> CTTTCATGGACCTGTCTTG
CGAAATCGATTCACGTACT -> GAAATCGATTCACGTACTG
CGAAGCTAATCTCTAAATA -> GAAGCTAATCTCTAAATAA
CGAAGCTGATTATATTTTG -> GAAGCTGATTATATTTTGT
CGAATGCGATTGTGAGGTC -> GAATGCGATTGTGAGGTCT
CGACACCTTTCAAACGTAG -> GACACCTTTCAAACGTAGT
CGACACTTACGTGATCGTT -> GACACTTACGTGATCGTTG
CGACAGCGTCGTTCGGAGA -> GACAGCGTCGTTCGGAGAT
CGACCCAGCTACTGTCAAG -> GACCCAGCTACTGTCAAGA
CGACCCCTTGTGCGGTCAG -> GACCCCTTGTGCGGTCAGA
CGACCCGGTCGTATCAAAG -> GACCCGGTCGTATCAAAGA
CGACCCTACCTTGGAGGAG -> GACCCTACCTTGGAGGAGA
CGACCCTCCCCACCTAACA -> GACCCTCCCCACCTAACAA
CGACCGACCCAGCTACTGT -> GACCGACCCAGCTACTGTC
CGACCGACCCCTTGTGCGG -> GACCGACCCCTTGTGCGGT
CGACCGACCCGGTCGTATC -> GACCGACCCGGTCGTATCA
CGACCGACCCTACCTTGGA -> GACCGACCCTACCTTGGAG
CGACGGTAATTGTGTTCCC -> GACGGTAATTGTGTTCCCT
CGACTTTCCATCCGGGTTC -> GACTTTCCATCCGGGTTCC
CGAGCATCTGGAAGGGATA -> GAGCATCTGGAAGGGATAC
CGAGCTCTGTATGGCTAAT -> GAGCTCTGTATGGCTAATC
CGAGGGAATACATTAACAC -> GAGGGAATACATTAACACA
CGAGTAACTTGTAAATCTT -> GAGTAACTTGTAAATCTTC
CGAGTTCTTACTGTCTCCA -> GAGTTCTTACTGTCTCCAT
CGATAATCTTTGGTATAGG -> GATAATCTTTGGTATAGGT
CGATAGGCCCCACGGGTAG -> GATAGGCCCCACGGGTAGC
CGATAGGCCCTCGACACTT -> GATAGGCCCTCGACACTTA
CGATCCAGGTGCACTCAAG -> GATCCAGGTGCACTCAAGT
CGATCGATTAGAATGTCTC -> GATCGATTAGAATGTCTCA
CGATCTTTAGACAGTGCAG -> GATCTTTAGACAGTGCAGA
CGATGGGATTATAGATAGC -> GATGGGATTATAGATAGCA
CGATTAGAATGTCTCACCT -> GATTAGAATGTCTCACCTA
CGATTCACGTACTGGTCAC -> GATTCACGTACTGGTCACT
CGATTCTGTACTAATAATT -> GATTCTGTACTAATAATTT
CGATTGTGAGGTCTTTTAG -> GATTGTGAGGTCTTTTAGT
CGCAAGCCTCAAGGCTACA -> GCAAGCCTCAAGGCTACAA
CGCAAGGGAGAATGAGTAC -> GCAAGGGAGAATGAGTACA
CGCAAGGGTACGTTTTATT -> GCAAGGGTACGTTTTATTA
CGCACTATCAAAGGAAGCG -> GCACTATCAAAGGAAGCGG
CGCATGACTTTATCACCAG -> GCATGACTTTATCACCAGC
CGCATTGTATATATAGAAT -> GCATTGTATATATAGAATT
CGCCACGTTCGACCGACCC -> GCCACGTTCGACCGACCCC
CGCCAGTAGTGGAGTGTAG -> GCCAGTAGTGGAGTGTAGG
CGCCCATTCTCCAAGGCTC -> GCCCATTCTCCAAGGCTCC
CGCCCCATTTTTTTGGGTA -> GCCCCATTTTTTTGGGTAG
CGCCGATCTTTAGACAGTG -> GCCGATCTTTAGACAGTGC
CGCCGCGGACTGTGGTGTA -> GCCGCGGACTGTGGTGTAG
CGCCTAAGGCCCCTTTAGG -> GCCTAAGGCCCCTTTAGGA
CGCCTCCGCCTAAGGCCCC -> GCCTCCGCCTAAGGCCCCT
CGCCTGATCCCCGCAAGGG -> GCCTGATCCCCGCAAGGGT
CGCGAGTTCTTACTGTCTC -> GCGAGTTCTTACTGTCTCC
CGCGCCAGTAGTGGAGTGT -> GCGCCAGTAGTGGAGTGTA
CGCGCTATCGCGGGGTCCA -> GCGCTATCGCGGGGTCCAA
CGCGGACACTTATAACGGA -> GCGGACACTTATAACGGAT
CGCGGACTGTGGTGTAGAA -> GCGGACTGTGGTGTAGAAC
CGCGGAGGTACGCCTGATC -> GCGGAGGTACGCCTGATCC
CGCGGCAGGAACAATCCGC -> GCGGCAGGAACAATCCGCG
CGCGGGGTCCAACTTTGTT -> GCGGGGTCCAACTTTGTTA
CGCGTTCAAGTATACGAGC -> GCGTTCAAGTATACGAGCA
CGCTACTGAATACACTGTG -> GCTACTGAATACACTGTGC
CGCTATCGCGGGGTCCAAC -> GCTATCGCGGGGTCCAACT
CGCTCAACCCGTGGACGCC -> GCTCAACCCGTGGACGCCG
CGCTCGCGTTCAAGTATAC -> GCTCGCGTTCAAGTATACG
CGCTGTGTTGATTCGTCCG -> GCTGTGTTGATTCGTCCGC
CGCTTACCGCGCTATCGCG -> GCTTACCGCGCTATCGCGG
CGGAAGATCGCTCAACCCG -> GGAAGATCGCTCAACCCGT
CGGACACTTATAACGGATT -> GGACACTTATAACGGATTT
CGGACTGTGGTGTAGAACG -> GGACTGTGGTGTAGAACGC
CGGAGATCCAGTGAGTTTG -> GGAGATCCAGTGAGTTTGG
CGGAGATCGGGGAGCCACC -> GGAGATCGGGGAGCCACCA
CGGAGGTACGCCTGATCCC -> GGAGGTACGCCTGATCCCC
CGGATTTATAGGAAAACGC -> GGATTTATAGGAAAACGCA
CGGCAAATCTCAGACCCAA -> GGCAAATCTCAGACCCAAG
CGGCAGGAACAATCCGCGG -> GGCAGGAACAATCCGCGGA
CGGCCGTCGTAGAGCGTCC -> GGCCGTCGTAGAGCGTCCC
CGGCTATTGCAGTCTTGAT -> GGCTATTGCAGTCTTGATT
CGGCTGAGCCTCGGCTGTG -> GGCTGAGCCTCGGCTGTGG
CGGCTGTGGCTACGTGCTA -> GGCTGTGGCTACGTGCTAA
CGGCTGTTTGCCAAGGTAC -> GGCTGTTTGCCAAGGTACA
CGGGACTTCCAGTCTTTAA -> GGGACTTCCAGTCTTTAAT
CGGGATTCTGTGCTACGAC -> GGGATTCTGTGCTACGACC
CGGGCCCGCTGTGTTGATT -> GGGCCCGCTGTGTTGATTC
CGGGCGTTTGCATTCGTCC -> GGGCGTTTGCATTCGTCCC
CGGGGAGCCACCAGATGGC -> GGGGAGCCACCAGATGGCG
CGGGGTCCAACTTTGTTAA -> GGGGTCCAACTTTGTTAAC
CGGGTAGCATTTGGTAAGA -> GGGTAGCATTTGGTAAGAC
CGGGTTAAGACCGCACTAT -> GGGTTAAGACCGCACTATC
CGGGTTCCAGCTAACTTGT -> GGGTTCCAGCTAACTTGTT
CGGTAATTGTGTTCCCTGT -> GGTAATTGTGTTCCCTGTC
CGGTCAGACAACAGAACTG -> GGTCAGACAACAGAACTGT
CGGTCGTATCAAAGACAAC -> GGTCGTATCAAAGACAACA
CGGTTCGATAATCTTTGGT -> GGTTCGATAATCTTTGGTA
CGGTTGTGGCAGCCAGGGA -> GGTTGTGGCAGCCAGGGAA
CGGTTTGTCTGATGCCTGG -> GGTTTGTCTGATGCCTGGC
CGTAAACAGCCTCCCACTA -> GTAAACAGCCTCCCACTAG
CGTAAAGAAAGTGTATCGT -> GTAAAGAAAGTGTATCGTC
CGTACTGGTCACTGCCCCA -> GTACTGGTCACTGCCCCAT
CGTAGAGCGTCCCGAGGGA -> GTAGAGCGTCCCGAGGGAA
CGTAGCCGCTTACCGCGCT -> GTAGCCGCTTACCGCGCTA
CGTAGCGTTTGGTCATTGG -> GTAGCGTTTGGTCATTGGA
CGTAGGGCATTTTGATCGA -> GTAGGGCATTTTGATCGAT
CGTAGTGTTTGCTTAGCGC -> GTAGTGTTTGCTTAGCGCT
CGTAGTTGATTCGACTTTC -> GTAGTTGATTCGACTTTCC
CGTATCAAAGACAACAGAA -> GTATCAAAGACAACAGAAC
CGTCCCGAGGGAATACATT -> GTCCCGAGGGAATACATTA
CGTCCCTGCCAGTCCTACG -> GTCCCTGCCAGTCCTACGA
CGTCCGCCCCATTTTTTTG -> GTCCGCCCCATTTTTTTGG
CGTCGACGGTAATTGTGTT -> GTCGACGGTAATTGTGTTC
CGTCGGCTGTTTGCCAAGG -> GTCGGCTGTTTGCCAAGGT
CGTCGTAGAGCGTCCCGAG -> GTCGTAGAGCGTCCCGAGG
CGTCGTTCGGAGATCGGGG -> GTCGTTCGGAGATCGGGGA
CGTCTCTGACATGACTACT -> GTCTCTGACATGACTACTT
CGTGACATCCGGCTATTGC -> GTGACATCCGGCTATTGCA
CGTGACCAATGTCTTAAAC -> GTGACCAATGTCTTAAACG
CGTGATCGTTGGAAAGCCC -> GTGATCGTTGGAAAGCCCG
CGTGCCACGTTCGACCGAC -> GTGCCACGTTCGACCGACC
CGTGCGGAGATCCAGTGAG -> GTGCGGAGATCCAGTGAGT
CGTGCTAAGTGCTGGTACG -> GTGCTAAGTGCTGGTACGT
CGTGGACGCCGATCTTTAG -> GTGGACGCCGATCTTTAGA
CGTGGTGGCCACGTTCGAC -> GTGGTGGCCACGTTCGACC
CGTTATTTCGAAGCTGATT -> GTTATTTCGAAGCTGATTA
CGTTCAAGTATACGAGCAT -> GTTCAAGTATACGAGCATC
CGTTCGACCGACCCAGCTA -> GTTCGACCGACCCAGCTAC
CGTTCGACCGACCCCTTGT -> GTTCGACCGACCCCTTGTG
CGTTCGACCGACCCGGTCG -> GTTCGACCGACCCGGTCGT
CGTTCGACCGACCCTACCT -> GTTCGACCGACCCTACCTT
CGTTCGGAGATCGGGGAGC -> GTTCGGAGATCGGGGAGCC
CGTTGCTCCGAAATCGATT -> GTTGCTCCGAAATCGATTC
CGTTGGAAAGCCCGGTTTG -> GTTGGAAAGCCCGGTTTGT
CGTTTGCATTCGTCCCTGC -> GTTTGCATTCGTCCCTGCC
CGTTTGGTCATTGGAGAGG -> GTTTGGTCATTGGAGAGGG
CGTTTTATTATTACCTGTG -> GTTTTATTATTACCTGTGT
CTAAATAATGGCAGCCATG -> TAAATAATGGCAGCCATGT
CTAACAAAACCGCGGCAGG -> TAACAAAACCGCGGCAGGA
CTAACTTGTTAGCGTCGAC -> TAACTTGTTAGCGTCGACG
CTAAGGCCCCTTTAGGAGT -> TAAGGCCCCTTTAGGAGTA
CTAAGTGCTGGTACGTTGC -> TAAGTGCTGGTACGTTGCT
CTAATAATTTCCGGGACTT -> TAATAATTTCCGGGACTTC
CTAATAGGTCTCAATCTCA -> TAATAGGTCTCAATCTCAT
CTAATATGAACCGTGCCAC -> TAATATGAACCGTGCCACG
CTAATCCTAGCCCGTAGCG -> TAATCCTAGCCCGTAGCGT
CTAATCTCTAAATAATGGC -> TAATCTCTAAATAATGGCA
CTACAATACTAGAAGGCCT -> TACAATACTAGAAGGCCTA
CTACAGAGACGTAGGGCAT -> TACAGAGACGTAGGGCATT
CTACCTTGGAGGAGACAAC -> TACCTTGGAGGAGACAACA
CTACGACACCTTTCAAACG -> TACGACACCTTTCAAACGT
CTACGACCCTCCCCACCTA -> TACGACCCTCCCCACCTAA
CTACGAGCTCTGTATGGCT -> TACGAGCTCTGTATGGCTA
CTACGCGAGTTCTTACTGT -> TACGCGAGTTCTTACTGTC
CTACGGAAGATCGCTCAAC -> TACGGAAGATCGCTCAACC
CTACGTGCTAAGTGCTGGT -> TACGTGCTAAGTGCTGGTA
CTACTGAATACACTGTGCG -> TACTGAATACACTGTGCGT
CTACTGTCAAGACAACAGA -> TACTGTCAAGACAACAGAA
CTACTTTGAACCTTTCATG -> TACTTTGAACCTTTCATGG
CTAGAAGGCCTACAGAGAC -> TAGAAGGCCTACAGAGACG
CTAGCCCGTAGCGTTTGGT -> TAGCCCGTAGCGTTTGGTC
CTAGCTTTAAGAAAACTAC -> TAGCTTTAAGAAAACTACG
CTAGGAAAATTGATAGAAA -> TAGGAAAATTGATAGAAAC
CTAGGAAATGTCGCAAGGG -> TAGGAAATGTCGCAAGGGA
CTAGGGCACGCCCATTCTC -> TAGGGCACGCCCATTCTCC
CTAGGTACTTTACGCTACT -> TAGGTACTTTACGCTACTG
CTAGTGGGGTATTTAATGA -> TAGTGGGGTATTTAATGAG
CTATAGGCAGTGTTTTATT -> TATAGGCAGTGTTTTATTT
CTATCAAAGGAAGCGGGAT -> TATCAAAGGAAGCGGGATT
CTATCGCGGGGTCCAACTT -> TATCGCGGGGTCCAACTTT
CTATTGCAGTATGGCCGGT -> TATTGCAGTATGGCCGGTT
CTATTGCAGTCTTGATTAG -> TATTGCAGTCTTGATTAGC
CTCAACCCGTGGACGCCGA -> TCAACCCGTGGACGCCGAT
CTCAAGGCTACAATACTAG -> TCAAGGCTACAATACTAGA
CTCAAGTAGGTCCCCCCTT -> TCAAGTAGGTCCCCCCTTG
CTCAATCTCATGGTACCGT -> TCAATCTCATGGTACCGTA
CTCACCTAATATGAACCGT -> TCACCTAATATGAACCGTG
CTCAGACCCAAGGGAAAAA -> TCAGACCCAAGGGAAAAAA
CTCATGGTACCGTAGTTGA -> TCATGGTACCGTAGTTGAT
CTCCAAGGCTCCTCCAGCC -> TCCAAGGCTCCTCCAGCCC
CTCCAGCCCGGGCGTTTGC -> TCCAGCCCGGGCGTTTGCA
CTCCATCCATACGATGGGA -> TCCATCCATACGATGGGAT
CTCCATCCATCAATATTTG -> TCCATCCATCAATATTTGA
CTCCCACTAGCTTTAAGAA -> TCCCACTAGCTTTAAGAAA
CTCCCCACCTAACAAAACC -> TCCCCACCTAACAAAACCG
CTCCGAAATCGATTCACGT -> TCCGAAATCGATTCACGTA
CTCCGCCTAAGGCCCCTTT -> TCCGCCTAAGGCCCCTTTA
CTCCTCCAGCCCGGGCGTT -> TCCTCCAGCCCGGGCGTTT
CTCCTGTCTTATCTACGCG -> TCCTGTCTTATCTACGCGA
CTCGACACTTACGTGATCG -> TCGACACTTACGTGATCGT
CTCGACAGCGTCGTTCGGA -> TCGACAGCGTCGTTCGGAG
CTCGCCGCGGACTGTGGTG -> TCGCCGCGGACTGTGGTGT
CTCGCGTTCAAGTATACGA -> TCGCGTTCAAGTATACGAG
CTCGGCTGTGGCTACGTGC -> TCGGCTGTGGCTACGTGCT
CTCTAAATAATGGCAGCCA -> TCTAAATAATGGCAGCCAT
CTCTAGGTACTTTACGCTA -> TCTAGGTACTTTACGCTAC
CTCTGACATGACTACTTTG -> TCTGACATGACTACTTTGA
CTCTGTATGGCTAATCCTA -> TCTGTATGGCTAATCCTAG
CTGAATACACTGTGCGTAA -> TGAATACACTGTGCGTAAA
CTGACATGACTACTTTGAA -> TGACATGACTACTTTGAAC
CTGACCGCCACGTTCGACC -> TGACCGCCACGTTCGACCG
CTGAGCCTCGGCTGTGGCT -> TGAGCCTCGGCTGTGGCTA
CTGATCCCCGCAAGGGTAC -> TGATCCCCGCAAGGGTACG
CTGATCCCGTGACATCCGG -> TGATCCCGTGACATCCGGC
CTGATGCCTGGCATTGCAT -> TGATGCCTGGCATTGCATC
CTGATTATATTTTGTCACC -> TGATTATATTTTGTCACCC
CTGCCAGTCCTACGACACC -> TGCCAGTCCTACGACACCT
CTGCCCCATGAGCCTACGA -> TGCCCCATGAGCCTACGAG
CTGCGATCCAGGTGCACTC -> TGCGATCCAGGTGCACTCA
CTGGAAGGGATACATTCTT -> TGGAAGGGATACATTCTTG
CTGGACAGTTAGAGTTTCA -> TGGACAGTTAGAGTTTCAA
CTGGCATTGCATCCACGGC -> TGGCATTGCATCCACGGCT
CTGGTACGTTGCTCCGAAA -> TGGTACGTTGCTCCGAAAT
CTGGTCACTGCCCCATGAG -> TGGTCACTGCCCCATGAGC
CTGGTTCAAACCTATAGGC -> TGGTTCAAACCTATAGGCA
CTGTACTAATAATTTCCGG -> TGTACTAATAATTTCCGGG
CTGTATCTAATAGGTCTCA -> TGTATCTAATAGGTCTCAA
CTGTATCTAGGAAAATTGA -> TGTATCTAGGAAAATTGAT
CTGTATCTATTGCAGTATG -> TGTATCTATTGCAGTATGG
CTGTATCTTCGAAGCTAAT -> TGTATCTTCGAAGCTAATC
CTGTATGGCTAATCCTAGC -> TGTATGGCTAATCCTAGCC
CTGTCAAGACAACAGAACT -> TGTCAAGACAACAGAACTG
CTGTCCACGATAGGCCCTC -> TGTCCACGATAGGCCCTCG
CTGTCTCCATCCATCAATA -> TGTCTCCATCCATCAATAT
CTGTCTTATCTACGCGAGT -> TGTCTTATCTACGCGAGTT
CTGTCTTGCTCGACAGCGT -> TGTCTTGCTCGACAGCGTC
CTGTGCGTAAAGAAAGTGT -> TGTGCGTAAAGAAAGTGTA
CTGTGCTACGACCCTCCCC -> TGTGCTACGACCCTCCCCA
CTGTGGCTACGTGCTAAGT -> TGTGGCTACGTGCTAAGTG
CTGTGGTGTAGAACGCTCA -> TGTGGTGTAGAACGCTCAA
CTGTGTCGCGCCAGTAGTG -> TGTGTCGCGCCAGTAGTGG
CTGTGTTGATTCGTCCGCC -> TGTGTTGATTCGTCCGCCC
CTGTTTGCCAAGGTACAGT -> TGTTTGCCAAGGTACAGTA
CTTAAACGTAAACAGCCTC -> TTAAACGTAAACAGCCTCC
CTTACCGCGCTATCGCGGG -> TTACCGCGCTATCGCGGGG
CTTACGTAGCCGCTTACCG -> TTACGTAGCCGCTTACCGC
CTTACGTGATCGTTGGAAA -> TTACGTGATCGTTGGAAAG
CTTACTGTCTCCATCCATC -> TTACTGTCTCCATCCATCA
CTTAGCGCTCGCGTTCAAG -> TTAGCGCTCGCGTTCAAGT
CTTATAACGGATTTATAGG -> TTATAACGGATTTATAGGA
CTTATCTACGCGAGTTCTT -> TTATCTACGCGAGTTCTTA
CTTCCAGTCTTTAATCACG -> TTCCAGTCTTTAATCACGG
CTTCGAAGCTAATCTCTAA -> TTCGAAGCTAATCTCTAAA
CTTCGATAGGCCCCACGGG -> TTCGATAGGCCCCACGGGT
CTTGATTAGCCGCAAGCCT -> TTGATTAGCCGCAAGCCTC
CTTGCTCGACAGCGTCGTT -> TTGCTCGACAGCGTCGTTC
CTTGGAGGAGACAACAGAA -> TTGGAGGAGACAACAGAAC
CTTGTAAATCTTCGATAGG -> TTGTAAATCTTCGATAGGC
CTTGTAGTCATTACAAATT -> TTGTAGTCATTACAAATTA
CTTGTCTGGACAGTTAGAG -> TTGTCTGGACAGTTAGAGT
CTTGTGCGGTCAGACAACA -> TTGTGCGGTCAGACAACAG
CTTGTTAGCGTCGACGGTA -> TTGTTAGCGTCGACGGTAA
CTTGTTGGGAACCATCCGT -> TTGTTGGGAACCATCCGTT
CTTTAAGAAAACTACGGAA -> TTTAAGAAAACTACGGAAG
CTTTAATCACGGGTTAAGA -> TTTAATCACGGGTTAAGAC
CTTTACGCTACTGAATACA -> TTTACGCTACTGAATACAC
CTTTAGACAGTGCAGAGTT -> TTTAGACAGTGCAGAGTTA
CTTTAGGAGTAAGGTTCTC -> TTTAGGAGTAAGGTTCTCC
CTTTATCACCAGCCACGTT -> TTTATCACCAGCCACGTTC
CTTTCAAACGTAGTGTTTG -> TTTCAAACGTAGTGTTTGC
CTTTCATGGACCTGTCTTG -> TTTCATGGACCTGTCTTGC
CTTTCCATCCGGGTTCCAG -> TTTCCATCCGGGTTCCAGC
CTTTGAACCTTTCATGGAC -> TTTGAACCTTTCATGGACC
CTTTGGTATAGGTGAAGGA -> TTTGGTATAGGTGAAGGAA
CTTTGTTAACTAGGAAATG -> TTTGTTAACTAGGAAATGT
CTTTTAGTGACTCGCCGCG -> TTTTAGTGACTCGCCGCGG
GAAAAAATCGAATGCGATT -> AAAAAATCGAATGCGATTG
GAAAACGCATGACTTTATC -> AAAACGCATGACTTTATCA
GAAAACTACGGAAGATCGC -> AAAACTACGGAAGATCGCT
GAAAATGTGACTGACCGCC -> AAAATGTGACTGACCGCCA
GAAAATTGATAGAAACATA -> AAAATTGATAGAAACATAC
GAAACATACCCAAGGGTGT -> AAACATACCCAAGGGTGTC
GAAAGCCCGGTTTGTCTGA -> AAAGCCCGGTTTGTCTGAT
GAAAGCGCCTCCGCCTAAG -> AAAGCGCCTCCGCCTAAGG
GAAAGTGTATCGTCGGCTG -> AAAGTGTATCGTCGGCTGT
GAAATCGATTCACGTACTG -> AAATCGATTCACGTACTGG
GAAATCTCTAGGTACTTTA -> AAATCTCTAGGTACTTTAC
GAAATGTCGCAAGGGAGAA -> AAATGTCGCAAGGGAGAAT
GAACAATCCGCGGAGGTAC -> AACAATCCGCGGAGGTACG
GAACCATCCGTTATTTCGA -> AACCATCCGTTATTTCGAA
GAACCGAGTAACTTGTAAA -> AACCGAGTAACTTGTAAAT
GAACCGTGCCACGTTCGAC -> AACCGTGCCACGTTCGACC
GAACCTTTCATGGACCTGT -> AACCTTTCATGGACCTGTC
GAACTGTATCTAATAGGTC -> AACTGTATCTAATAGGTCT
GAACTGTATCTAGGAAAAT -> AACTGTATCTAGGAAAATT
GAACTGTATCTATTGCAGT -> AACTGTATCTATTGCAGTA
GAACTGTATCTTCGAAGCT -> AACTGTATCTTCGAAGCTA
GAAGATATATAAATAGATG -> AAGATATATAAATAGATGA
GAAGATCGCTCAACCCGTG -> AAGATCGCTCAACCCGTGG
GAAGCGGGATTCTGTGCTA -> AAGCGGGATTCTGTGCTAC
GAAGCTAATCTCTAAATAA -> AAGCTAATCTCTAAATAAT
GAAGCTGATTATATTTTGT -> AAGCTGATTATATTTTGTC
GAAGCTGCGATCCAGGTGC -> AAGCTGCGATCCAGGTGCA
GAAGGAAGATATATAAATA -> AAGGAAGATATATAAATAG
GAAGGCCTACAGAGACGTA -> AAGGCCTACAGAGACGTAG
GAAGGGATACATTCTTGTA -> AAGGGATACATTCTTGTAG
GAATACACTGTGCGTAAAG -> AATACACTGTGCGTAAAGA
GAATACATTAACACAAAAT -> AATACATTAACACAAAATA
GAATGAGTACAAGAAGCTG -> AATGAGTACAAGAAGCTGC
GAATGCGATTGTGAGGTCT -> AATGCGATTGTGAGGTCTT
GAATGTCTCACCTAATATG -> AATGTCTCACCTAATATGA
GAATTGTTCACGTGGTGGC -> AATTGTTCACGTGGTGGCC
GACAACAGAACTGTATCTA -> ACAACAGAACTGTATCTAA,ACAACAGAACTGTATCTAG,ACAACAGAACTGTATCTAT
GACAACAGAACTGTATCTT -> ACAACAGAACTGTATCTTC
GACAACCAATCGCATTGTA -> ACAACCAATCGCATTGTAT
GACACCTTTCAAACGTAGT -> ACACCTTTCAAACGTAGTG
GACACTTACGTGATCGTTG -> ACACTTACGTGATCGTTGG
GACACTTATAACGGATTTA -> ACACTTATAACGGATTTAT
GACAGCGTCGTTCGGAGAT -> ACAGCGTCGTTCGGAGATC
GACAGTGCAGAGTTAAATG -> ACAGTGCAGAGTTAAATGC
GACAGTTAGAGTTTCAACC -> ACAGTTAGAGTTTCAACCC
GACATCCGGCTATTGCAGT -> ACATCCGGCTATTGCAGTC
GACATGACTACTTTGAACC -> ACATGACTACTTTGAACCT
GACCAATGTCTTAAACGTA -> ACCAATGTCTTAAACGTAA
GACCCAAGGGAAAAAATCG -> ACCCAAGGGAAAAAATCGA
GACCCAGCTACTGTCAAGA -> ACCCAGCTACTGTCAAGAC
GACCCCTTGTGCGGTCAGA -> ACCCCTTGTGCGGTCAGAC
GACCCGGTCGTATCAAAGA -> ACCCGGTCGTATCAAAGAC
GACCCTACCTTGGAGGAGA -> ACCCTACCTTGGAGGAGAC
GACCCTCCCCACCTAACAA -> ACCCTCCCCACCTAACAAA
GACCGACCCAGCTACTGTC -> ACCGACCCAGCTACTGTCA
GACCGACCCCTTGTGCGGT -> ACCGACCCCTTGTGCGGTC
GACCGACCCGGTCGTATCA -> ACCGACCCGGTCGTATCAA
GACCGACCCTACCTTGGAG -> ACCGACCCTACCTTGGAGG
GACCGCACTATCAAAGGAA -> ACCGCACTATCAAAGGAAG
GACCGCCACGTTCGACCGA -> ACCGCCACGTTCGACCGAC
GACCTGTCTTGCTCGACAG -> ACCTGTCTTGCTCGACAGC
GACGCCGATCTTTAGACAG -> ACGCCGATCTTTAGACAGT
GACGGTAATTGTGTTCCCT -> ACGGTAATTGTGTTCCCTG
GACGTAGGGCATTTTGATC -> ACGTAGGGCATTTTGATCG
GACTACTTTGAACCTTTCA -> ACTACTTTGAACCTTTCAT
GACTCCATCCATACGATGG -> ACTCCATCCATACGATGGG
GACTCGCCGCGGACTGTGG -> ACTCGCCGCGGACTGTGGT
GACTGACCGCCACGTTCGA -> ACTGACCGCCACGTTCGAC
GACTGTGGTGTAGAACGCT -> ACTGTGGTGTAGAACGCTC
GACTTCCAGTCTTTAATCA -> ACTTCCAGTCTTTAATCAC
GACTTTATCACCAGCCACG -> ACTTTATCACCAGCCACGT
GACTTTCCATCCGGGTTCC -> ACTTTCCATCCGGGTTCCA
GAGAATGAGTACAAGAAGC -> AGAATGAGTACAAGAAGCT
GAGACAACAGAACTGTATC -> AGACAACAGAACTGTATCT
GAGACGTAGGGCATTTTGA -> AGACGTAGGGCATTTTGAT
GAGAGGGTTCCGTCTCTGA -> AGAGGGTTCCGTCTCTGAC
GAGATCCAGTGAGTTTGGA -> AGATCCAGTGAGTTTGGAC
GAGATCGGGGAGCCACCAG -> AGATCGGGGAGCCACCAGA
GAGCATCTGGAAGGGATAC -> AGCATCTGGAAGGGATACA
GAGCCACCAGATGGCGCGG -> AGCCACCAGATGGCGCGGA
GAGCCTACGAGCTCTGTAT -> AGCCTACGAGCTCTGTATG
GAGCCTCGGCTGTGGCTAC -> AGCCTCGGCTGTGGCTACG
GAGCGTCCCGAGGGAATAC -> AGCGTCCCGAGGGAATACA
GAGCGTGCGGAGATCCAGT -> AGCGTGCGGAGATCCAGTG
GAGCTCTGTATGGCTAATC -> AGCTCTGTATGGCTAATCC
GAGGAGACAACAGAACTGT -> AGGAGACAACAGAACTGTA
GAGGGAATACATTAACACA -> AGGGAATACATTAACACAA
GAGGGATATCTGATCCCGT -> AGGGATATCTGATCCCGTG
GAGGGTTCCGTCTCTGACA -> AGGGTTCCGTCTCTGACAT
GAGGTACGCCTGATCCCCG -> AGGTACGCCTGATCCCCGC
GAGGTCTTTTAGTGACTCG -> AGGTCTTTTAGTGACTCGC
GAGTAACTTGTAAATCTTC -> AGTAACTTGTAAATCTTCG
GAGTAAGGTTCTCCTGTCT -> AGTAAGGTTCTCCTGTCTT
GAGTACAAGAAGCTGCGAT -> AGTACAAGAAGCTGCGATC
GAGTGTAGGATGCGTGACC -> AGTGTAGGATGCGTGACCA
GAGTTAAATGCGGGCCCGC -> AGTTAAATGCGGGCCCGCT
GAGTTCTTACTGTCTCCAT -> AGTTCTTACTGTCTCCATC
GAGTTTCAACCCGGCAAAT -> AGTTTCAACCCGGCAAATC
GAGTTTGGACAACCAATCG -> AGTTTGGACAACCAATCGC
GATAATCTTTGGTATAGGT -> ATAATCTTTGGTATAGGTG
GATACATTCTTGTAGTCAT -> ATACATTCTTGTAGTCATT
GATAGAAACATACCCAAGG -> ATAGAAACATACCCAAGGG
GATAGCAGTCAATGATCAA -> ATAGCAGTCAATGATCAAG
GATAGGCCCCACGGGTAGC -> ATAGGCCCCACGGGTAGCA
GATAGGCCCTCGACACTTA -> ATAGGCCCTCGACACTTAC
GATATATAAATAGATGAAA -> ATATATAAATAGATGAAAT
GATATCTGATCCCGTGACA -> ATATCTGATCCCGTGACAT
GATCAAGGCTTACGTAGCC -> ATCAAGGCTTACGTAGCCG
GATCCAGGTGCACTCAAGT -> ATCCAGGTGCACTCAAGTA
GATCCAGTGAGTTTGGACA -> ATCCAGTGAGTTTGGACAA
GATCCCCGCAAGGGTACGT -> ATCCCCGCAAGGGTACGTT
GATCCCGTGACATCCGGCT -> ATCCCGTGACATCCGGCTA
GATCGATCGATTAGAATGT -> ATCGATCGATTAGAATGTC
GATCGATTAGAATGTCTCA -> ATCGATTAGAATGTCTCAC
GATCGCTCAACCCGTGGAC -> ATCGCTCAACCCGTGGACG
GATCGGGGAGCCACCAGAT -> ATCGGGGAGCCACCAGATG
GATCGTTGGAAAGCCCGGT -> ATCGTTGGAAAGCCCGGTT
GATCTTTAGACAGTGCAGA -> ATCTTTAGACAGTGCAGAG
GATGAAATCTCTAGGTACT -> ATGAAATCTCTAGGTACTT
GATGCCTGGCATTGCATCC -> ATGCCTGGCATTGCATCCA
GATGCGTGACCAATGTCTT -> ATGCGTGACCAATGTCTTA
GATGGCGCGGACACTTATA -> ATGGCGCGGACACTTATAA
GATGGGATTATAGATAGCA -> ATGGGATTATAGATAGCAG
GATTAGAATGTCTCACCTA -> ATTAGAATGTCTCACCTAA
GATTAGCCGCAAGCCTCAA -> ATTAGCCGCAAGCCTCAAG
GATTATAGATAGCAGTCAA -> ATTATAGATAGCAGTCAAT
GATTATATTTTGTCACCCA -> ATTATATTTTGTCACCCAT
GATTCACGTACTGGTCACT -> ATTCACGTACTGGTCACTG
GATTCGACTTTCCATCCGG -> ATTCGACTTTCCATCCGGG
GATTCGTCCGCCCCATTTT -> ATTCGTCCGCCCCATTTTT
GATTCTGTACTAATAATTT -> ATTCTGTACTAATAATTTC
GATTCTGTGCTACGACCCT -> ATTCTGTGCTACGACCCTC
GATTGTGAGGTCTTTTAGT -> ATTGTGAGGTCTTTTAGTG
GATTTATAGGAAAACGCAT -> ATTTATAGGAAAACGCATG
GCAAATCTCAGACCCAAGG -> CAAATCTCAGACCCAAGGG
GCAAGCCTCAAGGCTACAA -> CAAGCCTCAAGGCTACAAT
GCAAGGGAGAATGAGTACA -> CAAGGGAGAATGAGTACAA
GCAAGGGTACGTTTTATTA -> CAAGGGTACGTTTTATTAT
GCACGCCCATTCTCCAAGG -> CACGCCCATTCTCCAAGGC
GCACTATCAAAGGAAGCGG -> CACTATCAAAGGAAGCGGG
GCACTCAAGTAGGTCCCCC -> CACTCAAGTAGGTCCCCCC
GCAGAGTTAAATGCGGGCC -> CAGAGTTAAATGCGGGCCC
GCAGCCAGGGAAAGCGCCT -> CAGCCAGGGAAAGCGCCTC
GCAGCCATGTTGGCTTGTC -> CAGCCATGTTGGCTTGTCT
GCAGGAACAATCCGCGGAG -> CAGGAACAATCCGCGGAGG
GCAGTATGGCCGGTTGTGG -> CAGTATGGCCGGTTGTGGC
GCAGTCAATGATCAAGGCT -> CAGTCAATGATCAAGGCTT
GCAGTCTTGATTAGCCGCA -> CAGTCTTGATTAGCCGCAA
GCAGTGTTTTATTTGCGGC -> CAGTGTTTTATTTGCGGCC
GCATCCACGGCTGAGCCTC -> CATCCACGGCTGAGCCTCG
GCATCTGGAAGGGATACAT -> CATCTGGAAGGGATACATT
GCATGACTTTATCACCAGC -> CATGACTTTATCACCAGCC
GCATTCGTCCCTGCCAGTC -> CATTCGTCCCTGCCAGTCC
GCATTGCATCCACGGCTGA -> CATTGCATCCACGGCTGAG
GCATTGTATATATAGAATT -> CATTGTATATATAGAATTG
GCATTTGGTAAGACTCCAT -> CATTTGGTAAGACTCCATC
GCATTTTGATCGATCGATT -> CATTTTGATCGATCGATTA
GCCAAGGTACAGTAATTGG -> CCAAGGTACAGTAATTGGT
GCCACCAGATGGCGCGGAC -> CCACCAGATGGCGCGGACA
GCCACGTTCGACCGACCCA -> CCACGTTCGACCGACCCAG
GCCACGTTCGACCGACCCC -> CCACGTTCGACCGACCCCT
GCCACGTTCGACCGACCCG -> CCACGTTCGACCGACCCGG
GCCACGTTCGACCGACCCT -> CCACGTTCGACCGACCCTA
GCCAGGGAAAGCGCCTCCG -> CCAGGGAAAGCGCCTCCGC
GCCAGTAGTGGAGTGTAGG -> CCAGTAGTGGAGTGTAGGA
GCCAGTCCTACGACACCTT -> CCAGTCCTACGACACCTTT
GCCATGTTGGCTTGTCTGG -> CCATGTTGGCTTGTCTGGA
GCCCATCTAGTGGGGTATT -> CCCATCTAGTGGGGTATTT
GCCCATTCTCCAAGGCTCC -> CCCATTCTCCAAGGCTCCT
GCCCCACGGGTAGCATTTG -> CCCCACGGGTAGCATTTGG
GCCCCATGAGCCTACGAGC -> CCCCATGAGCCTACGAGCT
GCCCCATTTTTTTGGGTAG -> CCCCATTTTTTTGGGTAGT
GCCCCTTTAGGAGTAAGGT -> CCCCTTTAGGAGTAAGGTT
GCCCGCTGTGTTGATTCGT -> CCCGCTGTGTTGATTCGTC
GCCCGGGCGTTTGCATTCG -> CCCGGGCGTTTGCATTCGT
GCCCGGTTTGTCTGATGCC -> CCCGGTTTGTCTGATGCCT
GCCCGTAGCGTTTGGTCAT -> CCCGTAGCGTTTGGTCATT
GCCCTCGACACTTACGTGA -> CCCTCGACACTTACGTGAT
GCCGATCTTTAGACAGTGC -> CCGATCTTTAGACAGTGCA
GCCGCAAGCCTCAAGGCTA -> CCGCAAGCCTCAAGGCTAC
GCCGCGGACTGTGGTGTAG -> CCGCGGACTGTGGTGTAGA
GCCGCTTACCGCGCTATCG -> CCGCTTACCGCGCTATCGC
GCCGGTTGTGGCAGCCAGG -> CCGGTTGTGGCAGCCAGGG
GCCGTCGTAGAGCGTCCCG -> CCGTCGTAGAGCGTCCCGA
GCCTAAGGCCCCTTTAGGA -> CCTAAGGCCCCTTTAGGAG
GCCTACAGAGACGTAGGGC -> CCTACAGAGACGTAGGGCA
GCCTACGAGCTCTGTATGG -> CCTACGAGCTCTGTATGGC
GCCTCAAGGCTACAATACT -> CCTCAAGGCTACAATACTA
GCCTCCCACTAGCTTTAAG -> CCTCCCACTAGCTTTAAGA
GCCTCCGCCTAAGGCCCCT -> CCTCCGCCTAAGGCCCCTT
GCCTCGGCTGTGGCTACGT -> CCTCGGCTGTGGCTACGTG
GCCTGATCCCCGCAAGGGT -> CCTGATCCCCGCAAGGGTA
GCCTGGCATTGCATCCACG -> CCTGGCATTGCATCCACGG
GCGAGTTCTTACTGTCTCC -> CGAGTTCTTACTGTCTCCA
GCGATCCAGGTGCACTCAA -> CGATCCAGGTGCACTCAAG
GCGATTGTGAGGTCTTTTA -> CGATTGTGAGGTCTTTTAG
GCGCCAGTAGTGGAGTGTA -> CGCCAGTAGTGGAGTGTAG
GCGCCTCCGCCTAAGGCCC -> CGCCTCCGCCTAAGGCCCC
GCGCGGACACTTATAACGG -> CGCGGACACTTATAACGGA
GCGCTATCGCGGGGTCCAA -> CGCTATCGCGGGGTCCAAC
GCGCTCGCGTTCAAGTATA -> CGCTCGCGTTCAAGTATAC
GCGGACACTTATAACGGAT -> CGGACACTTATAACGGATT
GCGGACTGTGGTGTAGAAC -> CGGACTGTGGTGTAGAACG
GCGGAGATCCAGTGAGTTT -> CGGAGATCCAGTGAGTTTG
GCGGAGGTACGCCTGATCC -> CGGAGGTACGCCTGATCCC
GCGGCAGGAACAATCCGCG -> CGGCAGGAACAATCCGCGG
GCGGCCGTCGTAGAGCGTC -> CGGCCGTCGTAGAGCGTCC
GCGGGATTCTGTGCTACGA -> CGGGATTCTGTGCTACGAC
GCGGGCCCGCTGTGTTGAT -> CGGGCCCGCTGTGTTGATT
GCGGGGTCCAACTTTGTTA -> CGGGGTCCAACTTTGTTAA
GCGGTCAGACAACAGAACT -> CGGTCAGACAACAGAACTG
GCGGTTCGATAATCTTTGG -> CGGTTCGATAATCTTTGGT
GCGTAAAGAAAGTGTATCG -> CGTAAAGAAAGTGTATCGT
GCGTCCCGAGGGAATACAT -> CGTCCCGAGGGAATACATT
GCGTCGACGGTAATTGTGT -> CGTCGACGGTAATTGTGTT
GCGTCGTTCGGAGATCGGG -> CGTCGTTCGGAGATCGGGG
GCGTGACCAATGTCTTAAA -> CGTGACCAATGTCTTAAAC
GCGTGCGGAGATCCAGTGA -> CGTGCGGAGATCCAGTGAG
GCGTTCAAGTATACGAGCA -> CGTTCAAGTATACGAGCAT
GCGTTTGCATTCGTCCCTG -> CGTTTGCATTCGTCCCTGC
GCGTTTGGTCATTGGAGAG -> CGTTTGGTCATTGGAGAGG
GCTAACTTGTTAGCGTCGA -> CTAACTTGTTAGCGTCGAC
GCTAAGTGCTGGTACGTTG -> CTAAGTGCTGGTACGTTGC
GCTAATCCTAGCCCGTAGC -> CTAATCCTAGCCCGTAGCG
GCTAATCTCTAAATAATGG -> CTAATCTCTAAATAATGGC
GCTACAATACTAGAAGGCC -> CTACAATACTAGAAGGCCT
GCTACGACCCTCCCCACCT -> CTACGACCCTCCCCACCTA
GCTACGTGCTAAGTGCTGG -> CTACGTGCTAAGTGCTGGT
GCTACTGAATACACTGTGC -> CTACTGAATACACTGTGCG
GCTACTGTCAAGACAACAG -> CTACTGTCAAGACAACAGA
GCTATCGCGGGGTCCAACT -> CTATCGCGGGGTCCAACTT
GCTATTGCAGTCTTGATTA -> CTATTGCAGTCTTGATTAG
GCTCAACCCGTGGACGCCG -> CTCAACCCGTGGACGCCGA
GCTCCGAAATCGATTCACG -> CTCCGAAATCGATTCACGT
GCTCCTCCAGCCCGGGCGT -> CTCCTCCAGCCCGGGCGTT
GCTCGACAGCGTCGTTCGG -> CTCGACAGCGTCGTTCGGA
GCTCGCGTTCAAGTATACG -> CTCGCGTTCAAGTATACGA
GCTCTGTATGGCTAATCCT -> CTCTGTATGGCTAATCCTA
GCTGAGCCTCGGCTGTGGC -> CTGAGCCTCGGCTGTGGCT
GCTGATTATATTTTGTCAC -> CTGATTATATTTTGTCACC
GCTGCGATCCAGGTGCACT -> CTGCGATCCAGGTGCACTC
GCTGGTACGTTGCTCCGAA -> CTGGTACGTTGCTCCGAAA
GCTGTGGCTACGTGCTAAG -> CTGTGGCTACGTGCTAAGT
GCTGTGTTGATTCGTCCGC -> CTGTGTTGATTCGTCCGCC
GCTGTTTGCCAAGGTACAG -> CTGTTTGCCAAGGTACAGT
GCTTACCGCGCTATCGCGG -> CTTACCGCGCTATCGCGGG
GCTTACGTAGCCGCTTACC -> CTTACGTAGCCGCTTACCG
GCTTAGCGCTCGCGTTCAA -> CTTAGCGCTCGCGTTCAAG
GCTTGTCTGGACAGTTAGA -> CTTGTCTGGACAGTTAGAG
GCTTTAAGAAAACTACGGA -> CTTTAAGAAAACTACGGAA
GGAAAAAATCGAATGCGAT -> GAAAAAATCGAATGCGATT
GGAAAACGCATGACTTTAT -> GAAAACGCATGACTTTATC
GGAAAATTGATAGAAACAT -> GAAAATTGATAGAAACATA
GGAAAGCCCGGTTTGTCTG -> GAAAGCCCGGTTTGTCTGA
GGAAAGCGCCTCCGCCTAA -> GAAAGCGCCTCCGCCTAAG
GGAAATGTCGCAAGGGAGA -> GAAATGTCGCAAGGGAGAA
GGAACAATCCGCGGAGGTA -> GAACAATCCGCGGAGGTAC
GGAACCATCCGTTATTTCG -> GAACCATCCGTTATTTCGA
GGAAGATATATAAATAGAT -> GAAGATATATAAATAGATG
GGAAGATCGCTCAACCCGT -> GAAGATCGCTCAACCCGTG
GGAAGCGGGATTCTGTGCT -> GAAGCGGGATTCTGTGCTA
GGAAGGGATACATTCTTGT -> GAAGGGATACATTCTTGTA
GGAATACATTAACACAAAA -> GAATACATTAACACAAAAT
GGACAACCAATCGCATTGT -> GACAACCAATCGCATTGTA
GGACACTTATAACGGATTT -> GACACTTATAACGGATTTA
GGACAGTTAGAGTTTCAAC -> GACAGTTAGAGTTTCAACC
GGACCTGTCTTGCTCGACA -> GACCTGTCTTGCTCGACAG
GGACGCCGATCTTTAGACA -> GACGCCGATCTTTAGACAG
GGACTGTGGTGTAGAACGC -> GACTGTGGTGTAGAACGCT
GGACTTCCAGTCTTTAATC -> GACTTCCAGTCTTTAATCA
GGAGAATGAGTACAAGAAG -> GAGAATGAGTACAAGAAGC
GGAGACAACAGAACTGTAT -> GAGACAACAGAACTGTATC
GGAGAGGGTTCCGTCTCTG -> GAGAGGGTTCCGTCTCTGA
GGAGATCCAGTGAGTTTGG -> GAGATCCAGTGAGTTTGGA
GGAGATCGGGGAGCCACCA -> GAGATCGGGGAGCCACCAG
GGAGCCACCAGATGGCGCG -> GAGCCACCAGATGGCGCGG
GGAGGAGACAACAGAACTG -> GAGGAGACAACAGAACTGT
GGAGGTACGCCTGATCCCC -> GAGGTACGCCTGATCCCCG
GGAGTAAGGTTCTCCTGTC -> GAGTAAGGTTCTCCTGTCT
GGAGTGTAGGATGCGTGAC -> GAGTGTAGGATGCGTGACC
GGATACATTCTTGTAGTCA -> GATACATTCTTGTAGTCAT
GGATATCTGATCCCGTGAC -> GATATCTGATCCCGTGACA
GGATGCGTGACCAATGTCT -> GATGCGTGACCAATGTCTT
GGATTATAGATAGCAGTCA -> GATTATAGATAGCAGTCAA
GGATTCTGTGCTACGACCC -> GATTCTGTGCTACGACCCT
GGATTTATAGGAAAACGCA -> GATTTATAGGAAAACGCAT
GGCAAATCTCAGACCCAAG -> GCAAATCTCAGACCCAAGG
GGCACGCCCATTCTCCAAG -> GCACGCCCATTCTCCAAGG
GGCAGCCAGGGAAAGCGCC -> GCAGCCAGGGAAAGCGCCT
GGCAGCCATGTTGGCTTGT -> GCAGCCATGTTGGCTTGTC
GGCAGGAACAATCCGCGGA -> GCAGGAACAATCCGCGGAG
GGCAGTGTTTTATTTGCGG -> GCAGTGTTTTATTTGCGGC
GGCATTGCATCCACGGCTG -> GCATTGCATCCACGGCTGA
GGCATTTTGATCGATCGAT -> GCATTTTGATCGATCGATT
GGCCACGTTCGACCGACCC -> GCCACGTTCGACCGACCCG
GGCCCCACGGGTAGCATTT -> GCCCCACGGGTAGCATTTG
GGCCCCTTTAGGAGTAAGG -> GCCCCTTTAGGAGTAAGGT
GGCCCGCTGTGTTGATTCG -> GCCCGCTGTGTTGATTCGT
GGCCCTCGACACTTACGTG -> GCCCTCGACACTTACGTGA
GGCCGGTTGTGGCAGCCAG -> GCCGGTTGTGGCAGCCAGG
GGCCGTCGTAGAGCGTCCC -> GCCGTCGTAGAGCGTCCCG
GGCCTACAGAGACGTAGGG -> GCCTACAGAGACGTAGGGC
GGCGCGGACACTTATAACG -> GCGCGGACACTTATAACGG
GGCGTTTGCATTCGTCCCT -> GCGTTTGCATTCGTCCCTG
GGCTAATCCTAGCCCGTAG -> GCTAATCCTAGCCCGTAGC
GGCTACAATACTAGAAGGC -> GCTACAATACTAGAAGGCC
GGCTACGTGCTAAGTGCTG -> GCTACGTGCTAAGTGCTGG
GGCTATTGCAGTCTTGATT -> GCTATTGCAGTCTTGATTA
GGCTCCTCCAGCCCGGGCG -> GCTCCTCCAGCCCGGGCGT
GGCTGAGCCTCGGCTGTGG -> GCTGAGCCTCGGCTGTGGC
GGCTGTGGCTACGTGCTAA -> GCTGTGGCTACGTGCTAAG
GGCTGTTTGCCAAGGTACA -> GCTGTTTGCCAAGGTACAG
GGCTTACGTAGCCGCTTAC -> GCTTACGTAGCCGCTTACC
GGCTTGTCTGGACAGTTAG -> GCTTGTCTGGACAGTTAGA
GGGAAAAAATCGAATGCGA -> GGAAAAAATCGAATGCGAT
GGGAAAGCGCCTCCGCCTA -> GGAAAGCGCCTCCGCCTAA
GGGAACCATCCGTTATTTC -> GGAACCATCCGTTATTTCG
GGGAATACATTAACACAAA -> GGAATACATTAACACAAAA
GGGACTTCCAGTCTTTAAT -> GGACTTCCAGTCTTTAATC
GGGAGAATGAGTACAAGAA -> GGAGAATGAGTACAAGAAG
GGGAGCCACCAGATGGCGC -> GGAGCCACCAGATGGCGCG
GGGATACATTCTTGTAGTC -> GGATACATTCTTGTAGTCA
GGGATATCTGATCCCGTGA -> GGATATCTGATCCCGTGAC
GGGATTATAGATAGCAGTC -> GGATTATAGATAGCAGTCA
GGGATTCTGTGCTACGACC -> GGATTCTGTGCTACGACCC
GGGCACGCCCATTCTCCAA -> GGCACGCCCATTCTCCAAG
GGGCATTTTGATCGATCGA -> GGCATTTTGATCGATCGAT
GGGCCCGCTGTGTTGATTC -> GGCCCGCTGTGTTGATTCG
GGGCGTTTGCATTCGTCCC -> GGCGTTTGCATTCGTCCCT
GGGGAGCCACCAGATGGCG -> GGGAGCCACCAGATGGCGC
GGGGTATTTAATGAGGGAT -> GGGTATTTAATGAGGGATA
GGGGTCCAACTTTGTTAAC -> GGGTCCAACTTTGTTAACT
GGGTACGTTTTATTATTAC -> GGTACGTTTTATTATTACC
GGGTAGCATTTGGTAAGAC -> GGTAGCATTTGGTAAGACT
GGGTAGTAATTGTGTATTT -> GGTAGTAATTGTGTATTTG
GGGTATTTAATGAGGGATA -> GGTATTTAATGAGGGATAT
GGGTCCAACTTTGTTAACT -> GGTCCAACTTTGTTAACTA
GGGTGCGGTTCGATAATCT -> GGTGCGGTTCGATAATCTT
GGGTGTCTAGGGCACGCCC -> GGTGTCTAGGGCACGCCCA
GGGTTAAGACCGCACTATC -> GGTTAAGACCGCACTATCA
GGGTTCCAGCTAACTTGTT -> GGTTCCAGCTAACTTGTTA
GGGTTCCGTCTCTGACATG -> GGTTCCGTCTCTGACATGA
GGTAAGACTCCATCCATAC -> GTAAGACTCCATCCATACG
GGTAATTGTGTTCCCTGTC -> GTAATTGTGTTCCCTGTCC
GGTACAGTAATTGGTTTTA -> GTACAGTAATTGGTTTTAA
GGTACCGTAGTTGATTCGA -> GTACCGTAGTTGATTCGAC
GGTACGCCTGATCCCCGCA -> GTACGCCTGATCCCCGCAA
GGTACGTTGCTCCGAAATC -> GTACGTTGCTCCGAAATCG
GGTACGTTTTATTATTACC -> GTACGTTTTATTATTACCT
GGTACTTTACGCTACTGAA -> GTACTTTACGCTACTGAAT
GGTAGCATTTGGTAAGACT -> GTAGCATTTGGTAAGACTC
GGTAGTAATTGTGTATTTG -> GTAGTAATTGTGTATTTGC
GGTATAGGTGAAGGAAGAT -> GTATAGGTGAAGGAAGATA
GGTATTTAATGAGGGATAT -> GTATTTAATGAGGGATATC
GGTCACTGCCCCATGAGCC -> GTCACTGCCCCATGAGCCT
GGTCAGACAACAGAACTGT -> GTCAGACAACAGAACTGTA
GGTCATTGGAGAGGGTTCC -> GTCATTGGAGAGGGTTCCG
GGTCCAACTTTGTTAACTA -> GTCCAACTTTGTTAACTAG
GGTCCCCCCTTGTTGGGAA -> GTCCCCCCTTGTTGGGAAC
GGTCGTATCAAAGACAACA -> GTCGTATCAAAGACAACAG
GGTCTCAATCTCATGGTAC -> GTCTCAATCTCATGGTACC
GGTCTTTTAGTGACTCGCC -> GTCTTTTAGTGACTCGCCG
GGTGAAGGAAGATATATAA -> GTGAAGGAAGATATATAAA
GGTGCACTCAAGTAGGTCC -> GTGCACTCAAGTAGGTCCC
GGTGCGGTTCGATAATCTT -> GTGCGGTTCGATAATCTTT
GGTGGCCACGTTCGACCGA -> GTGGCCACGTTCGACCGAC
GGTGTCTAGGGCACGCCCA -> GTGTCTAGGGCACGCCCAT
GGTTAAGACCGCACTATCA -> GTTAAGACCGCACTATCAA
GGTTCAAACCTATAGGCAG -> GTTCAAACCTATAGGCAGT
GGTTCCAGCTAACTTGTTA -> GTTCCAGCTAACTTGTTAG
GGTTCCGTCTCTGACATGA -> GTTCCGTCTCTGACATGAC
GGTTCGATAATCTTTGGTA -> GTTCGATAATCTTTGGTAT
GGTTCTCCTGTCTTATCTA -> GTTCTCCTGTCTTATCTAC
GGTTGTGGCAGCCAGGGAA -> GTTGTGGCAGCCAGGGAAA
GGTTTGTCTGATGCCTGGC -> GTTTGTCTGATGCCTGGCA
GGTTTTAATCTGGTTCAAA -> GTTTTAATCTGGTTCAAAC
GTAAACAGCCTCCCACTAG -> TAAACAGCCTCCCACTAGC
GTAAAGAAAGTGTATCGTC -> TAAAGAAAGTGTATCGTCG
GTAAATCTTCGATAGGCCC -> TAAATCTTCGATAGGCCCC
GTAACTTGTAAATCTTCGA -> TAACTTGTAAATCTTCGAT
GTAAGACTCCATCCATACG -> TAAGACTCCATCCATACGA
GTAAGGTTCTCCTGTCTTA -> TAAGGTTCTCCTGTCTTAT
GTAATTGGTTTTAATCTGG -> TAATTGGTTTTAATCTGGT
GTAATTGTGTATTTGCCCA -> TAATTGTGTATTTGCCCAT
GTAATTGTGTTCCCTGTCC -> TAATTGTGTTCCCTGTCCA
GTACAAGAAGCTGCGATCC -> TACAAGAAGCTGCGATCCA
GTACAGTAATTGGTTTTAA -> TACAGTAATTGGTTTTAAT
GTACCGTAGTTGATTCGAC -> TACCGTAGTTGATTCGACT
GTACGCCTGATCCCCGCAA -> TACGCCTGATCCCCGCAAG
GTACGTTGCTCCGAAATCG -> TACGTTGCTCCGAAATCGA
GTACGTTTTATTATTACCT -> TACGTTTTATTATTACCTG
GTACTAATAATTTCCGGGA -> TACTAATAATTTCCGGGAC
GTACTGGTCACTGCCCCAT -> TACTGGTCACTGCCCCATG
GTACTTTACGCTACTGAAT -> TACTTTACGCTACTGAATA
GTAGAGCGTCCCGAGGGAA -> TAGAGCGTCCCGAGGGAAT
GTAGCATTTGGTAAGACTC -> TAGCATTTGGTAAGACTCC
GTAGCCGCTTACCGCGCTA -> TAGCCGCTTACCGCGCTAT
GTAGCGTTTGGTCATTGGA -> TAGCGTTTGGTCATTGGAG
GTAGGATGCGTGACCAATG -> TAGGATGCGTGACCAATGT
GTAGGGCATTTTGATCGAT -> TAGGGCATTTTGATCGATC
GTAGGTCCCCCCTTGTTGG -> TAGGTCCCCCCTTGTTGGG
GTAGTAATTGTGTATTTGC -> TAGTAATTGTGTATTTGCC
GTAGTCATTACAAATTAAG -> TAGTCATTACAAATTAAGA
GTAGTGGAGTGTAGGATGC -> TAGTGGAGTGTAGGATGCG
GTAGTGTTTGCTTAGCGCT -> TAGTGTTTGCTTAGCGCTC
GTAGTTGATTCGACTTTCC -> TAGTTGATTCGACTTTCCA
GTATACGAGCATCTGGAAG -> TATACGAGCATCTGGAAGG
GTATAGGTGAAGGAAGATA -> TATAGGTGAAGGAAGATAT
GTATATATAGAATTGTTCA -> TATATATAGAATTGTTCAC
GTATCAAAGACAACAGAAC -> TATCAAAGACAACAGAACT
GTATCGTCGGCTGTTTGCC -> TATCGTCGGCTGTTTGCCA
GTATCTAATAGGTCTCAAT -> TATCTAATAGGTCTCAATC
GTATCTAGGAAAATTGATA -> TATCTAGGAAAATTGATAG
GTATCTATTGCAGTATGGC -> TATCTATTGCAGTATGGCC
GTATCTTCGAAGCTAATCT -> TATCTTCGAAGCTAATCTC
GTATGGCCGGTTGTGGCAG -> TATGGCCGGTTGTGGCAGC
GTATGGCTAATCCTAGCCC -> TATGGCTAATCCTAGCCCG
GTATTTAATGAGGGATATC -> TATTTAATGAGGGATATCT
GTATTTGCCCATCTAGTGG -> TATTTGCCCATCTAGTGGG
GTCAAGACAACAGAACTGT -> TCAAGACAACAGAACTGTA
GTCAATGATCAAGGCTTAC -> TCAATGATCAAGGCTTACG
GTCACCCATCAGTCATGAG -> TCACCCATCAGTCATGAGC
GTCACTGCCCCATGAGCCT -> TCACTGCCCCATGAGCCTA
GTCAGACAACAGAACTGTA -> TCAGACAACAGAACTGTAT
GTCATGAGCGTGCGGAGAT -> TCATGAGCGTGCGGAGATC
GTCATTACAAATTAAGAAC -> TCATTACAAATTAAGAACC
GTCATTGGAGAGGGTTCCG -> TCATTGGAGAGGGTTCCGT
GTCCAACTTTGTTAACTAG -> TCCAACTTTGTTAACTAGG
GTCCACGATAGGCCCTCGA -> TCCACGATAGGCCCTCGAC
GTCCCCCCTTGTTGGGAAC -> TCCCCCCTTGTTGGGAACC
GTCCCGAGGGAATACATTA -> TCCCGAGGGAATACATTAA
GTCCCTGCCAGTCCTACGA -> TCCCTGCCAGTCCTACGAC
GTCCGCCCCATTTTTTTGG -> TCCGCCCCATTTTTTTGGG
GTCCTACGACACCTTTCAA -> TCCTACGACACCTTTCAAA
GTCGACGGTAATTGTGTTC -> TCGACGGTAATTGTGTTCC
GTCGCAAGGGAGAATGAGT -> TCGCAAGGGAGAATGAGTA
GTCGCGCCAGTAGTGGAGT -> TCGCGCCAGTAGTGGAGTG
GTCGGCTGTTTGCCAAGGT -> TCGGCTGTTTGCCAAGGTA
GTCGTAGAGCGTCCCGAGG -> TCGTAGAGCGTCCCGAGGG
GTCGTATCAAAGACAACAG -> TCGTATCAAAGACAACAGA
GTCGTTCGGAGATCGGGGA -> TCGTTCGGAGATCGGGGAG
GTCTAGGGCACGCCCATTC -> TCTAGGGCACGCCCATTCT
GTCTCAATCTCATGGTACC -> TCTCAATCTCATGGTACCG
GTCTCACCTAATATGAACC -> TCTCACCTAATATGAACCG
GTCTCCATCCATCAATATT -> TCTCCATCCATCAATATTT
GTCTCTGACATGACTACTT -> TCTCTGACATGACTACTTT
GTCTGATGCCTGGCATTGC -> TCTGATGCCTGGCATTGCA
GTCTGGACAGTTAGAGTTT -> TCTGGACAGTTAGAGTTTC
GTCTTAAACGTAAACAGCC -> TCTTAAACGTAAACAGCCT
GTCTTATCTACGCGAGTTC -> TCTTATCTACGCGAGTTCT
GTCTTGATTAGCCGCAAGC -> TCTTGATTAGCCGCAAGCC
GTCTTGCTCGACAGCGTCG -> TCTTGCTCGACAGCGTCGT
GTCTTTAATCACGGGTTAA -> TCTTTAATCACGGGTTAAG
GTCTTTTAGTGACTCGCCG -> TCTTTTAGTGACTCGCCGC
GTGAAGGAAGATATATAAA -> TGAAGGAAGATATATAAAT
GTGACATCCGGCTATTGCA -> TGACATCCGGCTATTGCAG
GTGACCAATGTCTTAAACG -> TGACCAATGTCTTAAACGT
GTGACTCGCCGCGGACTGT -> TGACTCGCCGCGGACTGTG
GTGACTGACCGCCACGTTC -> TGACTGACCGCCACGTTCG
GTGAGGTCTTTTAGTGACT -> TGAGGTCTTTTAGTGACTC
GTGAGTTTGGACAACCAAT -> TGAGTTTGGACAACCAATC
GTGATCGTTGGAAAGCCCG -> TGATCGTTGGAAAGCCCGG
GTGCACTCAAGTAGGTCCC -> TGCACTCAAGTAGGTCCCC
GTGCAGAGTTAAATGCGGG -> TGCAGAGTTAAATGCGGGC
GTGCCACGTTCGACCGACC -> TGCCACGTTCGACCGACCC
GTGCGGAGATCCAGTGAGT -> TGCGGAGATCCAGTGAGTT
GTGCGGTCAGACAACAGAA -> TGCGGTCAGACAACAGAAC
GTGCGGTTCGATAATCTTT -> TGCGGTTCGATAATCTTTG
GTGCGTAAAGAAAGTGTAT -> TGCGTAAAGAAAGTGTATC
GTGCTAAGTGCTGGTACGT -> TGCTAAGTGCTGGTACGTT
GTGCTACGACCCTCCCCAC -> TGCTACGACCCTCCCCACC
GTGCTGGTACGTTGCTCCG -> TGCTGGTACGTTGCTCCGA
GTGGACGCCGATCTTTAGA -> TGGACGCCGATCTTTAGAC
GTGGAGTGTAGGATGCGTG -> TGGAGTGTAGGATGCGTGA
GTGGCAGCCAGGGAAAGCG -> TGGCAGCCAGGGAAAGCGC
GTGGCCACGTTCGACCGAC -> TGGCCACGTTCGACCGACC
GTGGCTACGTGCTAAGTGC -> TGGCTACGTGCTAAGTGCT
GTGGGGTATTTAATGAGGG -> TGGGGTATTTAATGAGGGA
GTGGGTGCGGTTCGATAAT -> TGGGTGCGGTTCGATAATC
GTGGTGGCCACGTTCGACC -> TGGTGGCCACGTTCGACCG
GTGTAGGATGCGTGACCAA -> TGTAGGATGCGTGACCAAT
GTGTATCGTCGGCTGTTTG -> TGTATCGTCGGCTGTTTGC
GTGTATTTGCCCATCTAGT -> TGTATTTGCCCATCTAGTG
GTGTCGCGCCAGTAGTGGA -> TGTCGCGCCAGTAGTGGAG
GTGTCTAGGGCACGCCCAT -> TGTCTAGGGCACGCCCATT
GTGTGGGTGCGGTTCGATA -> TGTGGGTGCGGTTCGATAA
GTGTTCCCTGTCCACGATA -> TGTTCCCTGTCCACGATAG
GTGTTGATTCGTCCGCCCC -> TGTTGATTCGTCCGCCCCA
GTGTTTGCTTAGCGCTCGC -> TGTTTGCTTAGCGCTCGCG
GTGTTTTATTTGCGGCCGT -> TGTTTTATTTGCGGCCGTC
GTTAAATGCGGGCCCGCTG -> TTAAATGCGGGCCCGCTGT
GTTAACTAGGAAATGTCGC -> TTAACTAGGAAATGTCGCA
GTTAAGACCGCACTATCAA -> TTAAGACCGCACTATCAAA
GTTAGAGTTTCAACCCGGC -> TTAGAGTTTCAACCCGGCA
GTTAGCGTCGACGGTAATT -> TTAGCGTCGACGGTAATTG
GTTATTTCGAAGCTGATTA -> TTATTTCGAAGCTGATTAT
GTTCAAACCTATAGGCAGT -> TTCAAACCTATAGGCAGTG
GTTCAAGTATACGAGCATC -> TTCAAGTATACGAGCATCT
GTTCACGTGGTGGCCACGT -> TTCACGTGGTGGCCACGTT
GTTCCAGCTAACTTGTTAG -> TTCCAGCTAACTTGTTAGC
GTTCCCTGTCCACGATAGG -> TTCCCTGTCCACGATAGGC
GTTCCGTCTCTGACATGAC -> TTCCGTCTCTGACATGACT
GTTCGACCGACCCAGCTAC -> TTCGACCGACCCAGCTACT
GTTCGACCGACCCCTTGTG -> TTCGACCGACCCCTTGTGC
GTTCGACCGACCCGGTCGT -> TTCGACCGACCCGGTCGTA
GTTCGACCGACCCTACCTT -> TTCGACCGACCCTACCTTG
GTTCGATAATCTTTGGTAT -> TTCGATAATCTTTGGTATA
GTTCGGAGATCGGGGAGCC -> TTCGGAGATCGGGGAGCCA
GTTCTCCTGTCTTATCTAC -> TTCTCCTGTCTTATCTACG
GTTCTTACTGTCTCCATCC -> TTCTTACTGTCTCCATCCA
GTTGATTCGACTTTCCATC -> TTGATTCGACTTTCCATCC
GTTGATTCGTCCGCCCCAT -> TTGATTCGTCCGCCCCATT
GTTGCTCCGAAATCGATTC -> TTGCTCCGAAATCGATTCA
GTTGGAAAGCCCGGTTTGT -> TTGGAAAGCCCGGTTTGTC
GTTGGCTTGTCTGGACAGT -> TTGGCTTGTCTGGACAGTT
GTTGGGAACCATCCGTTAT -> TTGGGAACCATCCGTTATT
GTTGTGGCAGCCAGGGAAA -> TTGTGGCAGCCAGGGAAAG
GTTTCAACCCGGCAAATCT -> TTTCAACCCGGCAAATCTC
GTTTGCATTCGTCCCTGCC -> TTTGCATTCGTCCCTGCCA
GTTTGCCAAGGTACAGTAA -> TTTGCCAAGGTACAGTAAT
GTTTGCTTAGCGCTCGCGT -> TTTGCTTAGCGCTCGCGTT
GTTTGGACAACCAATCGCA -> TTTGGACAACCAATCGCAT
GTTTGGTCATTGGAGAGGG -> TTTGGTCATTGGAGAGGGT
GTTTGTCTGATGCCTGGCA -> TTTGTCTGATGCCTGGCAT
GTTTTAATCTGGTTCAAAC -> TTTTAATCTGGTTCAAACC
GTTTTATTATTACCTGTGT -> TTTTATTATTACCTGTGTC
GTTTTATTTGCGGCCGTCG -> TTTTATTTGCGGCCGTCGT
TAAACAGCCTCCCACTAGC -> AAACAGCCTCCCACTAGCT
TAAACGTAAACAGCCTCCC -> AAACGTAAACAGCCTCCCA
TAAAGAAAGTGTATCGTCG -> AAAGAAAGTGTATCGTCGG
TAAATAATGGCAGCCATGT -> AAATAATGGCAGCCATGTT
TAAATAGATGAAATCTCTA -> AAATAGATGAAATCTCTAG
TAAATCTTCGATAGGCCCC -> AAATCTTCGATAGGCCCCA
TAAATGCGGGCCCGCTGTG -> AAATGCGGGCCCGCTGTGT
TAACAAAACCGCGGCAGGA -> AACAAAACCGCGGCAGGAA
TAACACAAAATATCGATTC -> AACACAAAATATCGATTCT
TAACGGATTTATAGGAAAA -> AACGGATTTATAGGAAAAC
TAACTAGGAAATGTCGCAA -> AACTAGGAAATGTCGCAAG
TAACTTGTAAATCTTCGAT -> AACTTGTAAATCTTCGATA
TAACTTGTTAGCGTCGACG -> AACTTGTTAGCGTCGACGG
TAAGAAAACTACGGAAGAT -> AAGAAAACTACGGAAGATC
TAAGAACCGAGTAACTTGT -> AAGAACCGAGTAACTTGTA
TAAGACCGCACTATCAAAG -> AAGACCGCACTATCAAAGG
TAAGACTCCATCCATACGA -> AAGACTCCATCCATACGAT
TAAGGCCCCTTTAGGAGTA -> AAGGCCCCTTTAGGAGTAA
TAAGGTTCTCCTGTCTTAT -> AAGGTTCTCCTGTCTTATC
TAAGTGCTGGTACGTTGCT -> AAGTGCTGGTACGTTGCTC
TAATAATTTCCGGGACTTC -> AATAATTTCCGGGACTTCC
TAATAGGTCTCAATCTCAT -> AATAGGTCTCAATCTCATG
TAATATGAACCGTGCCACG -> AATATGAACCGTGCCACGT
TAATCACGGGTTAAGACCG -> AATCACGGGTTAAGACCGC
TAATCCTAGCCCGTAGCGT -> AATCCTAGCCCGTAGCGTT
TAATCTCTAAATAATGGCA -> AATCTCTAAATAATGGCAG
TAATCTGGTTCAAACCTAT -> AATCTGGTTCAAACCTATA
TAATCTTTGGTATAGGTGA -> AATCTTTGGTATAGGTGAA
TAATGAGGGATATCTGATC -> AATGAGGGATATCTGATCC
TAATGGCAGCCATGTTGGC -> AATGGCAGCCATGTTGGCT
TAATTGGTTTTAATCTGGT -> AATTGGTTTTAATCTGGTT
TAATTGTGTATTTGCCCAT -> AATTGTGTATTTGCCCATC
TAATTGTGTTCCCTGTCCA -> AATTGTGTTCCCTGTCCAC
TAATTTCCGGGACTTCCAG -> AATTTCCGGGACTTCCAGT
TACAAATTAAGAACCGAGT -> ACAAATTAAGAACCGAGTA
TACAAGAAGCTGCGATCCA -> ACAAGAAGCTGCGATCCAG
TACAATACTAGAAGGCCTA -> ACAATACTAGAAGGCCTAC
TACACTGTGCGTAAAGAAA -> ACACTGTGCGTAAAGAAAG
TACAGAGACGTAGGGCATT -> ACAGAGACGTAGGGCATTT
TACAGTAATTGGTTTTAAT -> ACAGTAATTGGTTTTAATC
TACATTAACACAAAATATC -> ACATTAACACAAAATATCG
TACATTCTTGTAGTCATTA -> ACATTCTTGTAGTCATTAC
TACCCAAGGGTGTCTAGGG -> ACCCAAGGGTGTCTAGGGC
TACCGCGCTATCGCGGGGT -> ACCGCGCTATCGCGGGGTC
TACCGTAGTTGATTCGACT -> ACCGTAGTTGATTCGACTT
TACCTGTGTCGCGCCAGTA -> ACCTGTGTCGCGCCAGTAG
TACCTTGGAGGAGACAACA -> ACCTTGGAGGAGACAACAG
TACGACACCTTTCAAACGT -> ACGACACCTTTCAAACGTA
TACGACCCTCCCCACCTAA -> ACGACCCTCCCCACCTAAC
TACGAGCATCTGGAAGGGA -> ACGAGCATCTGGAAGGGAT
TACGAGCTCTGTATGGCTA -> ACGAGCTCTGTATGGCTAA
TACGATGGGATTATAGATA -> ACGATGGGATTATAGATAG
TACGCCTGATCCCCGCAAG -> ACGCCTGATCCCCGCAAGG
TACGCGAGTTCTTACTGTC -> ACGCGAGTTCTTACTGTCT
TACGCTACTGAATACACTG -> ACGCTACTGAATACACTGT
TACGGAAGATCGCTCAACC -> ACGGAAGATCGCTCAACCC
TACGTAGCCGCTTACCGCG -> ACGTAGCCGCTTACCGCGC
TACGTGATCGTTGGAAAGC -> ACGTGATCGTTGGAAAGCC
TACGTGCTAAGTGCTGGTA -> ACGTGCTAAGTGCTGGTAC
TACGTTGCTCCGAAATCGA -> ACGTTGCTCCGAAATCGAT
TACGTTTTATTATTACCTG -> ACGTTTTATTATTACCTGT
TACTAATAATTTCCGGGAC -> ACTAATAATTTCCGGGACT
TACTAGAAGGCCTACAGAG -> ACTAGAAGGCCTACAGAGA
TACTGAATACACTGTGCGT -> ACTGAATACACTGTGCGTA
TACTGGTCACTGCCCCATG -> ACTGGTCACTGCCCCATGA
TACTGTCAAGACAACAGAA -> ACTGTCAAGACAACAGAAC
TACTGTCTCCATCCATCAA -> ACTGTCTCCATCCATCAAT
TACTTTACGCTACTGAATA -> ACTTTACGCTACTGAATAC
TACTTTGAACCTTTCATGG -> ACTTTGAACCTTTCATGGA
TAGAAACATACCCAAGGGT -> AGAAACATACCCAAGGGTG
TAGAAGGCCTACAGAGACG -> AGAAGGCCTACAGAGACGT
TAGAATGTCTCACCTAATA -> AGAATGTCTCACCTAATAT
TAGAATTGTTCACGTGGTG -> AGAATTGTTCACGTGGTGG
TAGACAGTGCAGAGTTAAA -> AGACAGTGCAGAGTTAAAT
TAGAGCGTCCCGAGGGAAT -> AGAGCGTCCCGAGGGAATA
TAGAGTTTCAACCCGGCAA -> AGAGTTTCAACCCGGCAAA
TAGATAGCAGTCAATGATC -> AGATAGCAGTCAATGATCA
TAGATGAAATCTCTAGGTA -> AGATGAAATCTCTAGGTAC
TAGCAGTCAATGATCAAGG -> AGCAGTCAATGATCAAGGC
TAGCATTTGGTAAGACTCC -> AGCATTTGGTAAGACTCCA
TAGCCCGTAGCGTTTGGTC -> AGCCCGTAGCGTTTGGTCA
TAGCCGCAAGCCTCAAGGC -> AGCCGCAAGCCTCAAGGCT
TAGCCGCTTACCGCGCTAT -> AGCCGCTTACCGCGCTATC
TAGCGCTCGCGTTCAAGTA -> AGCGCTCGCGTTCAAGTAT
TAGCGTCGACGGTAATTGT -> AGCGTCGACGGTAATTGTG
TAGCGTTTGGTCATTGGAG -> AGCGTTTGGTCATTGGAGA
TAGCTTTAAGAAAACTACG -> AGCTTTAAGAAAACTACGG
TAGGAAAACGCATGACTTT -> AGGAAAACGCATGACTTTA
TAGGAAAATTGATAGAAAC -> AGGAAAATTGATAGAAACA
TAGGAAATGTCGCAAGGGA -> AGGAAATGTCGCAAGGGAG
TAGGAGTAAGGTTCTCCTG -> AGGAGTAAGGTTCTCCTGT
TAGGATGCGTGACCAATGT -> AGGATGCGTGACCAATGTC
TAGGCAGTGTTTTATTTGC -> AGGCAGTGTTTTATTTGCG
TAGGCCCCACGGGTAGCAT -> AGGCCCCACGGGTAGCATT
TAGGCCCTCGACACTTACG -> AGGCCCTCGACACTTACGT
TAGGGCACGCCCATTCTCC -> AGGGCACGCCCATTCTCCA
TAGGGCATTTTGATCGATC -> AGGGCATTTTGATCGATCG
TAGGTACTTTACGCTACTG -> AGGTACTTTACGCTACTGA
TAGGTCCCCCCTTGTTGGG -> AGGTCCCCCCTTGTTGGGA
TAGGTCTCAATCTCATGGT -> AGGTCTCAATCTCATGGTA
TAGGTGAAGGAAGATATAT -> AGGTGAAGGAAGATATATA
TAGTAATTGTGTATTTGCC -> AGTAATTGTGTATTTGCCC
TAGTCATTACAAATTAAGA -> AGTCATTACAAATTAAGAA
TAGTGACTCGCCGCGGACT -> AGTGACTCGCCGCGGACTG
TAGTGGAGTGTAGGATGCG -> AGTGGAGTGTAGGATGCGT
TAGTGGGGTATTTAATGAG -> AGTGGGGTATTTAATGAGG
TAGTGTTTGCTTAGCGCTC -> AGTGTTTGCTTAGCGCTCG
TAGTTGATTCGACTTTCCA -> AGTTGATTCGACTTTCCAT
TATAAATAGATGAAATCTC -> ATAAATAGATGAAATCTCT
TATAACGGATTTATAGGAA -> ATAACGGATTTATAGGAAA
TATACGAGCATCTGGAAGG -> ATACGAGCATCTGGAAGGG
TATAGAATTGTTCACGTGG -> ATAGAATTGTTCACGTGGT
TATAGATAGCAGTCAATGA -> ATAGATAGCAGTCAATGAT
TATAGGAAAACGCATGACT -> ATAGGAAAACGCATGACTT
TATAGGCAGTGTTTTATTT -> ATAGGCAGTGTTTTATTTG
TATAGGTGAAGGAAGATAT -> ATAGGTGAAGGAAGATATA
TATATAAATAGATGAAATC -> ATATAAATAGATGAAATCT
TATATAGAATTGTTCACGT -> ATATAGAATTGTTCACGTG
TATATATAGAATTGTTCAC -> ATATATAGAATTGTTCACG
TATATTTTGTCACCCATCA -> ATATTTTGTCACCCATCAG
TATCAAAGACAACAGAACT -> ATCAAAGACAACAGAACTG
TATCAAAGGAAGCGGGATT -> ATCAAAGGAAGCGGGATTC
TATCACCAGCCACGTTCGA -> ATCACCAGCCACGTTCGAC
TATCGATTCTGTACTAATA -> ATCGATTCTGTACTAATAA
TATCGCGGGGTCCAACTTT -> ATCGCGGGGTCCAACTTTG
TATCGTCGGCTGTTTGCCA -> ATCGTCGGCTGTTTGCCAA
TATCTAATAGGTCTCAATC -> ATCTAATAGGTCTCAATCT
TATCTACGCGAGTTCTTAC -> ATCTACGCGAGTTCTTACT
TATCTAGGAAAATTGATAG -> ATCTAGGAAAATTGATAGA
TATCTATTGCAGTATGGCC -> ATCTATTGCAGTATGGCCG
TATCTGATCCCGTGACATC -> ATCTGATCCCGTGACATCC
TATCTTCGAAGCTAATCTC -> ATCTTCGAAGCTAATCTCT
TATGAACCGTGCCACGTTC -> ATGAACCGTGCCACGTTCG
TATGGCCGGTTGTGGCAGC -> ATGGCCGGTTGTGGCAGCC
TATGGCTAATCCTAGCCCG -> ATGGCTAATCCTAGCCCGT
TATTACCTGTGTCGCGCCA -> ATTACCTGTGTCGCGCCAG
TATTATTACCTGTGTCGCG -> ATTATTACCTGTGTCGCGC
TATTGCAGTATGGCCGGTT -> ATTGCAGTATGGCCGGTTG
TATTGCAGTCTTGATTAGC -> ATTGCAGTCTTGATTAGCC
TATTTAATGAGGGATATCT -> ATTTAATGAGGGATATCTG
TATTTCGAAGCTGATTATA -> ATTTCGAAGCTGATTATAT
TATTTGAAAATGTGACTGA -> ATTTGAAAATGTGACTGAC
TATTTGCCCATCTAGTGGG -> ATTTGCCCATCTAGTGGGG
TATTTGCGGCCGTCGTAGA -> ATTTGCGGCCGTCGTAGAG
TATTTTGTCACCCATCAGT -> ATTTTGTCACCCATCAGTC
TCAAACCTATAGGCAGTGT -> CAAACCTATAGGCAGTGTT
TCAAACGTAGTGTTTGCTT -> CAAACGTAGTGTTTGCTTA
TCAAAGACAACAGAACTGT -> CAAAGACAACAGAACTGTA
TCAAAGGAAGCGGGATTCT -> CAAAGGAAGCGGGATTCTG
TCAACCCGGCAAATCTCAG -> CAACCCGGCAAATCTCAGA
TCAACCCGTGGACGCCGAT -> CAACCCGTGGACGCCGATC
TCAAGACAACAGAACTGTA -> CAAGACAACAGAACTGTAT
TCAAGGCTACAATACTAGA -> CAAGGCTACAATACTAGAA
TCAAGGCTTACGTAGCCGC -> CAAGGCTTACGTAGCCGCT
TCAAGTAGGTCCCCCCTTG -> CAAGTAGGTCCCCCCTTGT
TCAAGTATACGAGCATCTG -> CAAGTATACGAGCATCTGG
TCAATATTTGAAAATGTGA -> CAATATTTGAAAATGTGAC
TCAATCTCATGGTACCGTA -> CAATCTCATGGTACCGTAG
TCAATGATCAAGGCTTACG -> CAATGATCAAGGCTTACGT
TCACCAGCCACGTTCGACC -> CACCAGCCACGTTCGACCG
TCACCCATCAGTCATGAGC -> CACCCATCAGTCATGAGCG
TCACCTAATATGAACCGTG -> CACCTAATATGAACCGTGC
TCACGGGTTAAGACCGCAC -> CACGGGTTAAGACCGCACT
TCACGTACTGGTCACTGCC -> CACGTACTGGTCACTGCCC
TCACGTGGTGGCCACGTTC -> CACGTGGTGGCCACGTTCG
TCACTGCCCCATGAGCCTA -> CACTGCCCCATGAGCCTAC
TCAGACAACAGAACTGTAT -> CAGACAACAGAACTGTATC
TCAGACCCAAGGGAAAAAA -> CAGACCCAAGGGAAAAAAT
TCAGTCATGAGCGTGCGGA -> CAGTCATGAGCGTGCGGAG
TCATGAGCGTGCGGAGATC -> CATGAGCGTGCGGAGATCC
TCATGGACCTGTCTTGCTC -> CATGGACCTGTCTTGCTCG
TCATGGTACCGTAGTTGAT -> CATGGTACCGTAGTTGATT
TCATTACAAATTAAGAACC -> CATTACAAATTAAGAACCG
TCATTGGAGAGGGTTCCGT -> CATTGGAGAGGGTTCCGTC
TCCAACTTTGTTAACTAGG -> CCAACTTTGTTAACTAGGA
TCCAAGGCTCCTCCAGCCC -> CCAAGGCTCCTCCAGCCCG
TCCACGATAGGCCCTCGAC -> CCACGATAGGCCCTCGACA
TCCACGGCTGAGCCTCGGC -> CCACGGCTGAGCCTCGGCT
TCCAGCCCGGGCGTTTGCA -> CCAGCCCGGGCGTTTGCAT
TCCAGCTAACTTGTTAGCG -> CCAGCTAACTTGTTAGCGT
TCCAGGTGCACTCAAGTAG -> CCAGGTGCACTCAAGTAGG
TCCAGTCTTTAATCACGGG -> CCAGTCTTTAATCACGGGT
TCCAGTGAGTTTGGACAAC -> CCAGTGAGTTTGGACAACC
TCCATACGATGGGATTATA -> CCATACGATGGGATTATAG
TCCATCAATATTTGAAAAT -> CCATCAATATTTGAAAATG
TCCATCCATACGATGGGAT -> CCATCCATACGATGGGATT
TCCATCCATCAATATTTGA -> CCATCCATCAATATTTGAA
TCCATCCGGGTTCCAGCTA -> CCATCCGGGTTCCAGCTAA
TCCCACTAGCTTTAAGAAA -> CCCACTAGCTTTAAGAAAA
TCCCCACCTAACAAAACCG -> CCCCACCTAACAAAACCGC
TCCCCCCTTGTTGGGAACC -> CCCCCCTTGTTGGGAACCA
TCCCCGCAAGGGTACGTTT -> CCCCGCAAGGGTACGTTTT
TCCCGAGGGAATACATTAA -> CCCGAGGGAATACATTAAC
TCCCGTGACATCCGGCTAT -> CCCGTGACATCCGGCTATT
TCCCTGCCAGTCCTACGAC -> CCCTGCCAGTCCTACGACA
TCCCTGTCCACGATAGGCC -> CCCTGTCCACGATAGGCCC
TCCGAAATCGATTCACGTA -> CCGAAATCGATTCACGTAC
TCCGCCCCATTTTTTTGGG -> CCGCCCCATTTTTTTGGGT
TCCGCCTAAGGCCCCTTTA -> CCGCCTAAGGCCCCTTTAG
TCCGCGGAGGTACGCCTGA -> CCGCGGAGGTACGCCTGAT
TCCGGCTATTGCAGTCTTG -> CCGGCTATTGCAGTCTTGA
TCCGGGACTTCCAGTCTTT -> CCGGGACTTCCAGTCTTTA
TCCGGGTTCCAGCTAACTT -> CCGGGTTCCAGCTAACTTG
TCCGTCTCTGACATGACTA -> CCGTCTCTGACATGACTAC
TCCGTTATTTCGAAGCTGA -> CCGTTATTTCGAAGCTGAT
TCCTACGACACCTTTCAAA -> CCTACGACACCTTTCAAAC
TCCTAGCCCGTAGCGTTTG -> CCTAGCCCGTAGCGTTTGG
TCCTCCAGCCCGGGCGTTT -> CCTCCAGCCCGGGCGTTTG
TCCTGTCTTATCTACGCGA -> CCTGTCTTATCTACGCGAG
TCGAAGCTAATCTCTAAAT -> CGAAGCTAATCTCTAAATA
TCGAAGCTGATTATATTTT -> CGAAGCTGATTATATTTTG
TCGAATGCGATTGTGAGGT -> CGAATGCGATTGTGAGGTC
TCGACACTTACGTGATCGT -> CGACACTTACGTGATCGTT
TCGACAGCGTCGTTCGGAG -> CGACAGCGTCGTTCGGAGA
TCGACCGACCCAGCTACTG -> CGACCGACCCAGCTACTGT
TCGACCGACCCCTTGTGCG -> CGACCGACCCCTTGTGCGG
TCGACCGACCCGGTCGTAT -> CGACCGACCCGGTCGTATC
TCGACCGACCCTACCTTGG -> CGACCGACCCTACCTTGGA
TCGACGGTAATTGTGTTCC -> CGACGGTAATTGTGTTCCC
TCGACTTTCCATCCGGGTT -> CGACTTTCCATCCGGGTTC
TCGATAATCTTTGGTATAG -> CGATAATCTTTGGTATAGG
TCGATAGGCCCCACGGGTA -> CGATAGGCCCCACGGGTAG
TCGATCGATTAGAATGTCT -> CGATCGATTAGAATGTCTC
TCGATTAGAATGTCTCACC -> CGATTAGAATGTCTCACCT
TCGATTCACGTACTGGTCA -> CGATTCACGTACTGGTCAC
TCGATTCTGTACTAATAAT -> CGATTCTGTACTAATAATT
TCGCAAGGGAGAATGAGTA -> CGCAAGGGAGAATGAGTAC
TCGCATTGTATATATAGAA -> CGCATTGTATATATAGAAT
TCGCCGCGGACTGTGGTGT -> CGCCGCGGACTGTGGTGTA
TCGCGCCAGTAGTGGAGTG -> CGCGCCAGTAGTGGAGTGT
TCGCGGGGTCCAACTTTGT -> CGCGGGGTCCAACTTTGTT
TCGCGTTCAAGTATACGAG -> CGCGTTCAAGTATACGAGC
TCGCTCAACCCGTGGACGC -> CGCTCAACCCGTGGACGCC
TCGGAGATCGGGGAGCCAC -> CGGAGATCGGGGAGCCACC
TCGGCTGTGGCTACGTGCT -> CGGCTGTGGCTACGTGCTA
TCGGCTGTTTGCCAAGGTA -> CGGCTGTTTGCCAAGGTAC
TCGGGGAGCCACCAGATGG -> CGGGGAGCCACCAGATGGC
TCGTAGAGCGTCCCGAGGG -> CGTAGAGCGTCCCGAGGGA
TCGTATCAAAGACAACAGA -> CGTATCAAAGACAACAGAA
TCGTCCCTGCCAGTCCTAC -> CGTCCCTGCCAGTCCTACG
TCGTCCGCCCCATTTTTTT -> CGTCCGCCCCATTTTTTTG
TCGTCGGCTGTTTGCCAAG -> CGTCGGCTGTTTGCCAAGG
TCGTTCGGAGATCGGGGAG -> CGTTCGGAGATCGGGGAGC
TCGTTGGAAAGCCCGGTTT -> CGTTGGAAAGCCCGGTTTG
TCTAAATAATGGCAGCCAT -> CTAAATAATGGCAGCCATG
TCTAATAGGTCTCAATCTC -> CTAATAGGTCTCAATCTCA
TCTACGCGAGTTCTTACTG -> CTACGCGAGTTCTTACTGT
TCTAGGAAAATTGATAGAA -> CTAGGAAAATTGATAGAAA
TCTAGGGCACGCCCATTCT -> CTAGGGCACGCCCATTCTC
TCTAGGTACTTTACGCTAC -> CTAGGTACTTTACGCTACT
TCTAGTGGGGTATTTAATG -> CTAGTGGGGTATTTAATGA
TCTATTGCAGTATGGCCGG -> CTATTGCAGTATGGCCGGT
TCTCAATCTCATGGTACCG -> CTCAATCTCATGGTACCGT
TCTCACCTAATATGAACCG -> CTCACCTAATATGAACCGT
TCTCAGACCCAAGGGAAAA -> CTCAGACCCAAGGGAAAAA
TCTCATGGTACCGTAGTTG -> CTCATGGTACCGTAGTTGA
TCTCCAAGGCTCCTCCAGC -> CTCCAAGGCTCCTCCAGCC
TCTCCATCCATCAATATTT -> CTCCATCCATCAATATTTG
TCTCCTGTCTTATCTACGC -> CTCCTGTCTTATCTACGCG
TCTCTAAATAATGGCAGCC -> CTCTAAATAATGGCAGCCA
TCTCTAGGTACTTTACGCT -> CTCTAGGTACTTTACGCTA
TCTCTGACATGACTACTTT -> CTCTGACATGACTACTTTG
TCTGACATGACTACTTTGA -> CTGACATGACTACTTTGAA
TCTGATCCCGTGACATCCG -> CTGATCCCGTGACATCCGG
TCTGATGCCTGGCATTGCA -> CTGATGCCTGGCATTGCAT
TCTGGAAGGGATACATTCT -> CTGGAAGGGATACATTCTT
TCTGGACAGTTAGAGTTTC -> CTGGACAGTTAGAGTTTCA
TCTGGTTCAAACCTATAGG -> CTGGTTCAAACCTATAGGC
TCTGTACTAATAATTTCCG -> CTGTACTAATAATTTCCGG
TCTGTATGGCTAATCCTAG -> CTGTATGGCTAATCCTAGC
TCTGTGCTACGACCCTCCC -> CTGTGCTACGACCCTCCCC
TCTTAAACGTAAACAGCCT -> CTTAAACGTAAACAGCCTC
TCTTACTGTCTCCATCCAT -> CTTACTGTCTCCATCCATC
TCTTATCTACGCGAGTTCT -> CTTATCTACGCGAGTTCTT
TCTTCGAAGCTAATCTCTA -> CTTCGAAGCTAATCTCTAA
TCTTCGATAGGCCCCACGG -> CTTCGATAGGCCCCACGGG
TCTTGATTAGCCGCAAGCC -> CTTGATTAGCCGCAAGCCT
TCTTGCTCGACAGCGTCGT -> CTTGCTCGACAGCGTCGTT
TCTTGTAGTCATTACAAAT -> CTTGTAGTCATTACAAATT
TCTTTAATCACGGGTTAAG -> CTTTAATCACGGGTTAAGA
TCTTTAGACAGTGCAGAGT -> CTTTAGACAGTGCAGAGTT
TCTTTGGTATAGGTGAAGG -> CTTTGGTATAGGTGAAGGA
TCTTTTAGTGACTCGCCGC -> CTTTTAGTGACTCGCCGCG
TGAAAATGTGACTGACCGC -> GAAAATGTGACTGACCGCC
TGAAATCTCTAGGTACTTT -> GAAATCTCTAGGTACTTTA
TGAACCGTGCCACGTTCGA -> GAACCGTGCCACGTTCGAC
TGAACCTTTCATGGACCTG -> GAACCTTTCATGGACCTGT
TGAAGGAAGATATATAAAT -> GAAGGAAGATATATAAATA
TGAATACACTGTGCGTAAA -> GAATACACTGTGCGTAAAG
TGACATCCGGCTATTGCAG -> GACATCCGGCTATTGCAGT
TGACATGACTACTTTGAAC -> GACATGACTACTTTGAACC
TGACCAATGTCTTAAACGT -> GACCAATGTCTTAAACGTA
TGACCGCCACGTTCGACCG -> GACCGCCACGTTCGACCGA
TGACTACTTTGAACCTTTC -> GACTACTTTGAACCTTTCA
TGACTCGCCGCGGACTGTG -> GACTCGCCGCGGACTGTGG
TGACTGACCGCCACGTTCG -> GACTGACCGCCACGTTCGA
TGACTTTATCACCAGCCAC -> GACTTTATCACCAGCCACG
TGAGCCTACGAGCTCTGTA -> GAGCCTACGAGCTCTGTAT
TGAGCCTCGGCTGTGGCTA -> GAGCCTCGGCTGTGGCTAC
TGAGCGTGCGGAGATCCAG -> GAGCGTGCGGAGATCCAGT
TGAGGGATATCTGATCCCG -> GAGGGATATCTGATCCCGT
TGAGGTCTTTTAGTGACTC -> GAGGTCTTTTAGTGACTCG
TGAGTACAAGAAGCTGCGA -> GAGTACAAGAAGCTGCGAT
TGAGTTTGGACAACCAATC -> GAGTTTGGACAACCAATCG
TGATAGAAACATACCCAAG -> GATAGAAACATACCCAAGG
TGATCAAGGCTTACGTAGC -> GATCAAGGCTTACGTAGCC
TGATCCCCGCAAGGGTACG -> GATCCCCGCAAGGGTACGT
TGATCCCGTGACATCCGGC -> GATCCCGTGACATCCGGCT
TGATCGATCGATTAGAATG -> GATCGATCGATTAGAATGT
TGATCGTTGGAAAGCCCGG -> GATCGTTGGAAAGCCCGGT
TGATGCCTGGCATTGCATC -> GATGCCTGGCATTGCATCC
TGATTAGCCGCAAGCCTCA -> GATTAGCCGCAAGCCTCAA
TGATTATATTTTGTCACCC -> GATTATATTTTGTCACCCA
TGATTCGACTTTCCATCCG -> GATTCGACTTTCCATCCGG
TGATTCGTCCGCCCCATTT -> GATTCGTCCGCCCCATTTT
TGCACTCAAGTAGGTCCCC -> GCACTCAAGTAGGTCCCCC
TGCAGAGTTAAATGCGGGC -> GCAGAGTTAAATGCGGGCC
TGCAGTATGGCCGGTTGTG -> GCAGTATGGCCGGTTGTGG
TGCAGTCTTGATTAGCCGC -> GCAGTCTTGATTAGCCGCA
TGCATCCACGGCTGAGCCT -> GCATCCACGGCTGAGCCTC
TGCATTCGTCCCTGCCAGT -> GCATTCGTCCCTGCCAGTC
TGCCAAGGTACAGTAATTG -> GCCAAGGTACAGTAATTGG
TGCCACGTTCGACCGACCC -> GCCACGTTCGACCGACCCT
TGCCAGTCCTACGACACCT -> GCCAGTCCTACGACACCTT
TGCCCATCTAGTGGGGTAT -> GCCCATCTAGTGGGGTATT
TGCCCCATGAGCCTACGAG -> GCCCCATGAGCCTACGAGC
TGCCTGGCATTGCATCCAC -> GCCTGGCATTGCATCCACG
TGCGATCCAGGTGCACTCA -> GCGATCCAGGTGCACTCAA
TGCGATTGTGAGGTCTTTT -> GCGATTGTGAGGTCTTTTA
TGCGGAGATCCAGTGAGTT -> GCGGAGATCCAGTGAGTTT
TGCGGCCGTCGTAGAGCGT -> GCGGCCGTCGTAGAGCGTC
TGCGGGCCCGCTGTGTTGA -> GCGGGCCCGCTGTGTTGAT
TGCGGTCAGACAACAGAAC -> GCGGTCAGACAACAGAACT
TGCGGTTCGATAATCTTTG -> GCGGTTCGATAATCTTTGG
TGCGTAAAGAAAGTGTATC -> GCGTAAAGAAAGTGTATCG
TGCGTGACCAATGTCTTAA -> GCGTGACCAATGTCTTAAA
TGCTAAGTGCTGGTACGTT -> GCTAAGTGCTGGTACGTTG
TGCTACGACCCTCCCCACC -> GCTACGACCCTCCCCACCT
TGCTCCGAAATCGATTCAC -> GCTCCGAAATCGATTCACG
TGCTCGACAGCGTCGTTCG -> GCTCGACAGCGTCGTTCGG
TGCTGGTACGTTGCTCCGA -> GCTGGTACGTTGCTCCGAA
TGCTTAGCGCTCGCGTTCA -> GCTTAGCGCTCGCGTTCAA
TGGAAAGCCCGGTTTGTCT -> GGAAAGCCCGGTTTGTCTG
TGGAAGGGATACATTCTTG -> GGAAGGGATACATTCTTGT
TGGACAACCAATCGCATTG -> GGACAACCAATCGCATTGT
TGGACAGTTAGAGTTTCAA -> GGACAGTTAGAGTTTCAAC
TGGACCTGTCTTGCTCGAC -> GGACCTGTCTTGCTCGACA
TGGACGCCGATCTTTAGAC -> GGACGCCGATCTTTAGACA
TGGAGAGGGTTCCGTCTCT -> GGAGAGGGTTCCGTCTCTG
TGGAGGAGACAACAGAACT -> GGAGGAGACAACAGAACTG
TGGAGTGTAGGATGCGTGA -> GGAGTGTAGGATGCGTGAC
TGGCAGCCAGGGAAAGCGC -> GGCAGCCAGGGAAAGCGCC
TGGCAGCCATGTTGGCTTG -> GGCAGCCATGTTGGCTTGT
TGGCATTGCATCCACGGCT -> GGCATTGCATCCACGGCTG
TGGCCACGTTCGACCGACC -> GGCCACGTTCGACCGACCC
TGGCCGGTTGTGGCAGCCA -> GGCCGGTTGTGGCAGCCAG
TGGCGCGGACACTTATAAC -> GGCGCGGACACTTATAACG
TGGCTAATCCTAGCCCGTA -> GGCTAATCCTAGCCCGTAG
TGGCTACGTGCTAAGTGCT -> GGCTACGTGCTAAGTGCTG
TGGCTTGTCTGGACAGTTA -> GGCTTGTCTGGACAGTTAG
TGGGAACCATCCGTTATTT -> GGGAACCATCCGTTATTTC
TGGGATTATAGATAGCAGT -> GGGATTATAGATAGCAGTC
TGGGGTATTTAATGAGGGA -> GGGGTATTTAATGAGGGAT
TGGGTAGTAATTGTGTATT -> GGGTAGTAATTGTGTATTT
TGGGTGCGGTTCGATAATC -> GGGTGCGGTTCGATAATCT
TGGTAAGACTCCATCCATA -> GGTAAGACTCCATCCATAC
TGGTACCGTAGTTGATTCG -> GGTACCGTAGTTGATTCGA
TGGTACGTTGCTCCGAAAT -> GGTACGTTGCTCCGAAATC
TGGTATAGGTGAAGGAAGA -> GGTATAGGTGAAGGAAGAT
TGGTCACTGCCCCATGAGC -> GGTCACTGCCCCATGAGCC
TGGTCATTGGAGAGGGTTC -> GGTCATTGGAGAGGGTTCC
TGGTGGCCACGTTCGACCG -> GGTGGCCACGTTCGACCGA
TGGTTCAAACCTATAGGCA -> GGTTCAAACCTATAGGCAG
TGGTTTTAATCTGGTTCAA -> GGTTTTAATCTGGTTCAAA
TGTAAATCTTCGATAGGCC -> GTAAATCTTCGATAGGCCC
TGTACTAATAATTTCCGGG -> GTACTAATAATTTCCGGGA
TGTAGGATGCGTGACCAAT -> GTAGGATGCGTGACCAATG
TGTAGTCATTACAAATTAA -> GTAGTCATTACAAATTAAG
TGTATATATAGAATTGTTC -> GTATATATAGAATTGTTCA
TGTATCGTCGGCTGTTTGC -> GTATCGTCGGCTGTTTGCC
TGTATCTAATAGGTCTCAA -> GTATCTAATAGGTCTCAAT
TGTATCTAGGAAAATTGAT -> GTATCTAGGAAAATTGATA
TGTATCTATTGCAGTATGG -> GTATCTATTGCAGTATGGC
TGTATCTTCGAAGCTAATC -> GTATCTTCGAAGCTAATCT
TGTATGGCTAATCCTAGCC -> GTATGGCTAATCCTAGCCC
TGTATTTGCCCATCTAGTG -> GTATTTGCCCATCTAGTGG
TGTCAAGACAACAGAACTG -> GTCAAGACAACAGAACTGT
TGTCACCCATCAGTCATGA -> GTCACCCATCAGTCATGAG
TGTCCACGATAGGCCCTCG -> GTCCACGATAGGCCCTCGA
TGTCGCAAGGGAGAATGAG -> GTCGCAAGGGAGAATGAGT
TGTCGCGCCAGTAGTGGAG -> GTCGCGCCAGTAGTGGAGT
TGTCTAGGGCACGCCCATT -> GTCTAGGGCACGCCCATTC
TGTCTCACCTAATATGAAC -> GTCTCACCTAATATGAACC
TGTCTCCATCCATCAATAT -> GTCTCCATCCATCAATATT
TGTCTGATGCCTGGCATTG -> GTCTGATGCCTGGCATTGC
TGTCTGGACAGTTAGAGTT -> GTCTGGACAGTTAGAGTTT
TGTCTTAAACGTAAACAGC -> GTCTTAAACGTAAACAGCC
TGTCTTATCTACGCGAGTT -> GTCTTATCTACGCGAGTTC
TGTCTTGCTCGACAGCGTC -> GTCTTGCTCGACAGCGTCG
TGTGACTGACCGCCACGTT -> GTGACTGACCGCCACGTTC
TGTGAGGTCTTTTAGTGAC -> GTGAGGTCTTTTAGTGACT
TGTGCGGTCAGACAACAGA -> GTGCGGTCAGACAACAGAA
TGTGCGTAAAGAAAGTGTA -> GTGCGTAAAGAAAGTGTAT
TGTGCTACGACCCTCCCCA -> GTGCTACGACCCTCCCCAC
TGTGGCAGCCAGGGAAAGC -> GTGGCAGCCAGGGAAAGCG
TGTGGCTACGTGCTAAGTG -> GTGGCTACGTGCTAAGTGC
TGTGGGTGCGGTTCGATAA -> GTGGGTGCGGTTCGATAAT
TGTGTATTTGCCCATCTAG -> GTGTATTTGCCCATCTAGT
TGTGTCGCGCCAGTAGTGG -> GTGTCGCGCCAGTAGTGGA
TGTGTTCCCTGTCCACGAT -> GTGTTCCCTGTCCACGATA
TGTGTTGATTCGTCCGCCC -> GTGTTGATTCGTCCGCCCC
TGTTAACTAGGAAATGTCG -> GTTAACTAGGAAATGTCGC
TGTTAGCGTCGACGGTAAT -> GTTAGCGTCGACGGTAATT
TGTTCACGTGGTGGCCACG -> GTTCACGTGGTGGCCACGT
TGTTCCCTGTCCACGATAG -> GTTCCCTGTCCACGATAGG
TGTTGATTCGTCCGCCCCA -> GTTGATTCGTCCGCCCCAT
TGTTGGCTTGTCTGGACAG -> GTTGGCTTGTCTGGACAGT
TGTTGGGAACCATCCGTTA -> GTTGGGAACCATCCGTTAT
TGTTTGCCAAGGTACAGTA -> GTTTGCCAAGGTACAGTAA
TGTTTGCTTAGCGCTCGCG -> GTTTGCTTAGCGCTCGCGT
TGTTTTATTTGCGGCCGTC -> GTTTTATTTGCGGCCGTCG
TTAAACGTAAACAGCCTCC -> TAAACGTAAACAGCCTCCC
TTAAATGCGGGCCCGCTGT -> TAAATGCGGGCCCGCTGTG
TTAACACAAAATATCGATT -> TAACACAAAATATCGATTC
TTAACTAGGAAATGTCGCA -> TAACTAGGAAATGTCGCAA
TTAAGAAAACTACGGAAGA -> TAAGAAAACTACGGAAGAT
TTAAGAACCGAGTAACTTG -> TAAGAACCGAGTAACTTGT
TTAAGACCGCACTATCAAA -> TAAGACCGCACTATCAAAG
TTAATCACGGGTTAAGACC -> TAATCACGGGTTAAGACCG
TTAATCTGGTTCAAACCTA -> TAATCTGGTTCAAACCTAT
TTAATGAGGGATATCTGAT -> TAATGAGGGATATCTGATC
TTACAAATTAAGAACCGAG -> TACAAATTAAGAACCGAGT
TTACCGCGCTATCGCGGGG -> TACCGCGCTATCGCGGGGT
TTACCTGTGTCGCGCCAGT -> TACCTGTGTCGCGCCAGTA
TTACGCTACTGAATACACT -> TACGCTACTGAATACACTG
TTACGTAGCCGCTTACCGC -> TACGTAGCCGCTTACCGCG
TTACGTGATCGTTGGAAAG -> TACGTGATCGTTGGAAAGC
TTACTGTCTCCATCCATCA -> TACTGTCTCCATCCATCAA
TTAGAATGTCTCACCTAAT -> TAGAATGTCTCACCTAATA
TTAGACAGTGCAGAGTTAA -> TAGACAGTGCAGAGTTAAA
TTAGAGTTTCAACCCGGCA -> TAGAGTTTCAACCCGGCAA
TTAGCCGCAAGCCTCAAGG -> TAGCCGCAAGCCTCAAGGC
TTAGCGCTCGCGTTCAAGT -> TAGCGCTCGCGTTCAAGTA
TTAGCGTCGACGGTAATTG -> TAGCGTCGACGGTAATTGT
TTAGGAGTAAGGTTCTCCT -> TAGGAGTAAGGTTCTCCTG
TTAGTGACTCGCCGCGGAC -> TAGTGACTCGCCGCGGACT
TTATAACGGATTTATAGGA -> TATAACGGATTTATAGGAA
TTATAGATAGCAGTCAATG -> TATAGATAGCAGTCAATGA
TTATAGGAAAACGCATGAC -> TATAGGAAAACGCATGACT
TTATATTTTGTCACCCATC -> TATATTTTGTCACCCATCA
TTATCACCAGCCACGTTCG -> TATCACCAGCCACGTTCGA
TTATCTACGCGAGTTCTTA -> TATCTACGCGAGTTCTTAC
TTATTACCTGTGTCGCGCC -> TATTACCTGTGTCGCGCCA
TTATTATTACCTGTGTCGC -> TATTATTACCTGTGTCGCG
TTATTTCGAAGCTGATTAT -> TATTTCGAAGCTGATTATA
TTATTTGCGGCCGTCGTAG -> TATTTGCGGCCGTCGTAGA
TTCAAACCTATAGGCAGTG -> TCAAACCTATAGGCAGTGT
TTCAAACGTAGTGTTTGCT -> TCAAACGTAGTGTTTGCTT
TTCAACCCGGCAAATCTCA -> TCAACCCGGCAAATCTCAG
TTCAAGTATACGAGCATCT -> TCAAGTATACGAGCATCTG
TTCACGTACTGGTCACTGC -> TCACGTACTGGTCACTGCC
TTCACGTGGTGGCCACGTT -> TCACGTGGTGGCCACGTTC
TTCATGGACCTGTCTTGCT -> TCATGGACCTGTCTTGCTC
TTCCAGCTAACTTGTTAGC -> TCCAGCTAACTTGTTAGCG
TTCCAGTCTTTAATCACGG -> TCCAGTCTTTAATCACGGG
TTCCATCCGGGTTCCAGCT -> TCCATCCGGGTTCCAGCTA
TTCCCTGTCCACGATAGGC -> TCCCTGTCCACGATAGGCC
TTCCGGGACTTCCAGTCTT -> TCCGGGACTTCCAGTCTTT
TTCCGTCTCTGACATGACT -> TCCGTCTCTGACATGACTA
TTCGAAGCTAATCTCTAAA -> TCGAAGCTAATCTCTAAAT
TTCGAAGCTGATTATATTT -> TCGAAGCTGATTATATTTT
TTCGACCGACCCAGCTACT -> TCGACCGACCCAGCTACTG
TTCGACCGACCCCTTGTGC -> TCGACCGACCCCTTGTGCG
TTCGACCGACCCGGTCGTA -> TCGACCGACCCGGTCGTAT
TTCGACCGACCCTACCTTG -> TCGACCGACCCTACCTTGG
TTCGACTTTCCATCCGGGT -> TCGACTTTCCATCCGGGTT
TTCGATAATCTTTGGTATA -> TCGATAATCTTTGGTATAG
TTCGATAGGCCCCACGGGT -> TCGATAGGCCCCACGGGTA
TTCGGAGATCGGGGAGCCA -> TCGGAGATCGGGGAGCCAC
TTCGTCCCTGCCAGTCCTA -> TCGTCCCTGCCAGTCCTAC
TTCGTCCGCCCCATTTTTT -> TCGTCCGCCCCATTTTTTT
TTCTCCAAGGCTCCTCCAG -> TCTCCAAGGCTCCTCCAGC
TTCTCCTGTCTTATCTACG -> TCTCCTGTCTTATCTACGC
TTCTGTACTAATAATTTCC -> TCTGTACTAATAATTTCCG
TTCTGTGCTACGACCCTCC -> TCTGTGCTACGACCCTCCC
TTCTTACTGTCTCCATCCA -> TCTTACTGTCTCCATCCAT
TTCTTGTAGTCATTACAAA -> TCTTGTAGTCATTACAAAT
TTGAAAATGTGACTGACCG -> TGAAAATGTGACTGACCGC
TTGAACCTTTCATGGACCT -> TGAACCTTTCATGGACCTG
TTGATAGAAACATACCCAA -> TGATAGAAACATACCCAAG
TTGATCGATCGATTAGAAT -> TGATCGATCGATTAGAATG
TTGATTAGCCGCAAGCCTC -> TGATTAGCCGCAAGCCTCA
TTGATTCGACTTTCCATCC -> TGATTCGACTTTCCATCCG
TTGATTCGTCCGCCCCATT -> TGATTCGTCCGCCCCATTT
TTGCAGTATGGCCGGTTGT -> TGCAGTATGGCCGGTTGTG
TTGCAGTCTTGATTAGCCG -> TGCAGTCTTGATTAGCCGC
TTGCATCCACGGCTGAGCC -> TGCATCCACGGCTGAGCCT
TTGCATTCGTCCCTGCCAG -> TGCATTCGTCCCTGCCAGT
TTGCCAAGGTACAGTAATT -> TGCCAAGGTACAGTAATTG
TTGCCCATCTAGTGGGGTA -> TGCCCATCTAGTGGGGTAT
TTGCGGCCGTCGTAGAGCG -> TGCGGCCGTCGTAGAGCGT
TTGCTCCGAAATCGATTCA -> TGCTCCGAAATCGATTCAC
TTGCTCGACAGCGTCGTTC -> TGCTCGACAGCGTCGTTCG
TTGCTTAGCGCTCGCGTTC -> TGCTTAGCGCTCGCGTTCA
TTGGAAAGCCCGGTTTGTC -> TGGAAAGCCCGGTTTGTCT
TTGGACAACCAATCGCATT -> TGGACAACCAATCGCATTG
TTGGAGAGGGTTCCGTCTC -> TGGAGAGGGTTCCGTCTCT
TTGGAGGAGACAACAGAAC -> TGGAGGAGACAACAGAACT
TTGGCTTGTCTGGACAGTT -> TGGCTTGTCTGGACAGTTA
TTGGGAACCATCCGTTATT -> TGGGAACCATCCGTTATTT
TTGGGTAGTAATTGTGTAT -> TGGGTAGTAATTGTGTATT
TTGGTAAGACTCCATCCAT -> TGGTAAGACTCCATCCATA
TTGGTATAGGTGAAGGAAG -> TGGTATAGGTGAAGGAAGA
TTGGTCATTGGAGAGGGTT -> TGGTCATTGGAGAGGGTTC
TTGGTTTTAATCTGGTTCA -> TGGTTTTAATCTGGTTCAA
TTGTAAATCTTCGATAGGC -> TGTAAATCTTCGATAGGCC
TTGTAGTCATTACAAATTA -> TGTAGTCATTACAAATTAA
TTGTATATATAGAATTGTT -> TGTATATATAGAATTGTTC
TTGTCACCCATCAGTCATG -> TGTCACCCATCAGTCATGA
TTGTCTGATGCCTGGCATT -> TGTCTGATGCCTGGCATTG
TTGTCTGGACAGTTAGAGT -> TGTCTGGACAGTTAGAGTT
TTGTGAGGTCTTTTAGTGA -> TGTGAGGTCTTTTAGTGAC
TTGTGCGGTCAGACAACAG -> TGTGCGGTCAGACAACAGA
TTGTGGCAGCCAGGGAAAG -> TGTGGCAGCCAGGGAAAGC
TTGTGTATTTGCCCATCTA -> TGTGTATTTGCCCATCTAG
TTGTGTTCCCTGTCCACGA -> TGTGTTCCCTGTCCACGAT
TTGTTAACTAGGAAATGTC -> TGTTAACTAGGAAATGTCG
TTGTTAGCGTCGACGGTAA -> TGTTAGCGTCGACGGTAAT
TTGTTCACGTGGTGGCCAC -> TGTTCACGTGGTGGCCACG
TTGTTGGGAACCATCCGTT -> TGTTGGGAACCATCCGTTA
TTTAAGAAAACTACGGAAG -> TTAAGAAAACTACGGAAGA
TTTAATCACGGGTTAAGAC -> TTAATCACGGGTTAAGACC
TTTAATCTGGTTCAAACCT -> TTAATCTGGTTCAAACCTA
TTTAATGAGGGATATCTGA -> TTAATGAGGGATATCTGAT
TTTACGCTACTGAATACAC -> TTACGCTACTGAATACACT
TTTAGACAGTGCAGAGTTA -> TTAGACAGTGCAGAGTTAA
TTTAGGAGTAAGGTTCTCC -> TTAGGAGTAAGGTTCTCCT
TTTAGTGACTCGCCGCGGA -> TTAGTGACTCGCCGCGGAC
TTTATAGGAAAACGCATGA -> TTATAGGAAAACGCATGAC
TTTATCACCAGCCACGTTC -> TTATCACCAGCCACGTTCG
TTTATTATTACCTGTGTCG -> TTATTATTACCTGTGTCGC
TTTATTTGCGGCCGTCGTA -> TTATTTGCGGCCGTCGTAG
TTTCAAACGTAGTGTTTGC -> TTCAAACGTAGTGTTTGCT
TTTCAACCCGGCAAATCTC -> TTCAACCCGGCAAATCTCA
TTTCATGGACCTGTCTTGC -> TTCATGGACCTGTCTTGCT
TTTCCATCCGGGTTCCAGC -> TTCCATCCGGGTTCCAGCT
TTTCCGGGACTTCCAGTCT -> TTCCGGGACTTCCAGTCTT
TTTCGAAGCTGATTATATT -> TTCGAAGCTGATTATATTT
TTTGAAAATGTGACTGACC -> TTGAAAATGTGACTGACCG
TTTGAACCTTTCATGGACC -> TTGAACCTTTCATGGACCT
TTTGATCGATCGATTAGAA -> TTGATCGATCGATTAGAAT
TTTGCATTCGTCCCTGCCA -> TTGCATTCGTCCCTGCCAG
TTTGCCAAGGTACAGTAAT -> TTGCCAAGGTACAGTAATT
TTTGCCCATCTAGTGGGGT -> TTGCCCATCTAGTGGGGTA
TTTGCGGCCGTCGTAGAGC -> TTGCGGCCGTCGTAGAGCG
TTTGCTTAGCGCTCGCGTT -> TTGCTTAGCGCTCGCGTTC
TTTGGACAACCAATCGCAT -> TTGGACAACCAATCGCATT
TTTGGGTAGTAATTGTGTA -> TTGGGTAGTAATTGTGTAT
TTTGGTAAGACTCCATCCA -> TTGGTAAGACTCCATCCAT
TTTGGTATAGGTGAAGGAA -> TTGGTATAGGTGAAGGAAG
TTTGGTCATTGGAGAGGGT -> TTGGTCATTGGAGAGGGTT
TTTGTCACCCATCAGTCAT -> TTGTCACCCATCAGTCATG
TTTGTCTGATGCCTGGCAT -> TTGTCTGATGCCTGGCATT
TTTGTTAACTAGGAAATGT -> TTGTTAACTAGGAAATGTC
TTTTAATCTGGTTCAAACC -> TTTAATCTGGTTCAAACCT
TTTTAGTGACTCGCCGCGG -> TTTAGTGACTCGCCGCGGA
TTTTATTATTACCTGTGTC -> TTTATTATTACCTGTGTCG
TTTTATTTGCGGCCGTCGT -> TTTATTTGCGGCCGTCGTA
TTTTGATCGATCGATTAGA -> TTTGATCGATCGATTAGAA
TTTTGGGTAGTAATTGTGT -> TTTGGGTAGTAATTGTGTA
TTTTGTCACCCATCAGTCA -> TTTGTCACCCATCAGTCAT
TTTTTGGGTAGTAATTGTG -> TTTTGGGTAGTAATTGTGT
TTTTTTGGGTAGTAATTGT -> TTTTTGGGTAGTAATTGTG
TTTTTTTGGGTAGTAATTG -> TTTTTTGGGTAGTAATTGT
