AAAACTGCGCTAGGCGCTGT -> AAACTGCGCTAGGCGCTGTA
AAAAGCTACAATTGTAGTAG -> AAAGCTACAATTGTAGTAGT
AAACGCAATAAATACTGCGC -> AACGCAATAAATACTGCGCT
AAACGTAATTAGAGACGCTG -> AACGTAATTAGAGACGCTGC
AAACTCCGTGCAGGTGAGCC -> AACTCCGTGCAGGTGAGCCC
AAACTCTGGCCCCGTGTTAG -> AACTCTGGCCCCGTGTTAGA
AAACTGCGCTAGGCGCTGTA -> AACTGCGCTAGGCGCTGTAC
AAAGCTACAATTGTAGTAGT -> AAGCTACAATTGTAGTAGTG
AAAGTACGTCCGTCCTCACA -> AAGTACGTCCGTCCTCACAA
AAAGTTTAATCATGCCTCCA -> AAGTTTAATCATGCCTCCAC
AAATACTGCGCTCAGCTGAC -> AATACTGCGCTCAGCTGACA
AAATCGCCACGCTAGCGGGC -> AATCGCCACGCTAGCGGGCG
AAATGTAAAACTGCGCTAGG -> AATGTAAAACTGCGCTAGGC
AACAAGACGAAGTGTATAGT -> ACAAGACGAAGTGTATAGTA
AACAGGGTCCCAATGAGTTA -> ACAGGGTCCCAATGAGTTAC
AACCCGAACTTCAAACTCTG -> ACCCGAACTTCAAACTCTGG
AACCCGACATTATCTATAGT -> ACCCGACATTATCTATAGTC
AACCCTAGTCTGGTACTCGG -> ACCCTAGTCTGGTACTCGGG
AACGCAATAAATACTGCGCT -> ACGCAATAAATACTGCGCTC
AACGGAGGACCGGCCCAGGT -> ACGGAGGACCGGCCCAGGTC
AACGTAATTAGAGACGCTGC -> ACGTAATTAGAGACGCTGCT
AACGTTAGCGGAAAGTACGT -> ACGTTAGCGGAAAGTACGTC
AACTCCGTGCAGGTGAGCCC -> ACTCCGTGCAGGTGAGCCCC
AACTCTGGCCCCGTGTTAGA -> ACTCTGGCCCCGTGTTAGAA
AACTGCGCTAGGCGCTGTAC -> ACTGCGCTAGGCGCTGTACC
AACTGGGCAGATCGGAACCC -> ACTGGGCAGATCGGAACCCG
AACTTCAAACTCTGGCCCCG -> ACTTCAAACTCTGGCCCCGT
AAGACGAAGTGTATAGTATC -> AGACGAAGTGTATAGTATCA
AAGACTAGGGCGCTGCTACG -> AGACTAGGGCGCTGCTACGA
AAGCATCAGGATGGTATGTA -> AGCATCAGGATGGTATGTAA
AAGCATTTTTCTTTCGGTAA -> AGCATTTTTCTTTCGGTAAT
AAGCGTTAGATGGTCCAATC -> AGCGTTAGATGGTCCAATCA
AAGCTACAATTGTAGTAGTG -> AGCTACAATTGTAGTAGTGG
AAGCTTAAGACTAGGGCGCT -> AGCTTAAGACTAGGGCGCTG
AAGGAATTTACATGATCCTC -> AGGAATTTACATGATCCTCC
AAGGATGGTAAATCGCCACG -> AGGATGGTAAATCGCCACGC
AAGTACGTCCGTCCTCACAA -> AGTACGTCCGTCCTCACAAA
AAGTGTATAGTATCAATAAG -> AGTGTATAGTATCAATAAGG
AAGTGTGAGTGTAGCTAGTC -> AGTGTGAGTGTAGCTAGTCG
AAGTTAGAACATACTATCAA -> AGTTAGAACATACTATCAAT
AAGTTTAATCATGCCTCCAC -> AGTTTAATCATGCCTCCACC
AATAAATACTGCGCTCAGCT -> ATAAATACTGCGCTCAGCTG
AATAAGGAATTTACATGATC -> ATAAGGAATTTACATGATCC
AATACCGAAGTTAGAACATA -> ATACCGAAGTTAGAACATAC
AATACTGCGCTCAGCTGACA -> ATACTGCGCTCAGCTGACAA
AATATCGACCTGTGAAACGC -> ATATCGACCTGTGAAACGCA
AATCACGACGAATGGGTAGA -> ATCACGACGAATGGGTAGAG
AATCAGCCACTTTGCGACGC -> ATCAGCCACTTTGCGACGCG
AATCATGCCTCCACCAGGGG -> ATCATGCCTCCACCAGGGGT
AATCGCCACGCTAGCGGGCG -> ATCGCCACGCTAGCGGGCGT
AATGAGTTACCAGTCCCGCC -> ATGAGTTACCAGTCCCGCCT
AATGCTCAGCCGAAACTCCG -> ATGCTCAGCCGAAACTCCGT
AATGGGTAGAGAGATTACTC -> ATGGGTAGAGAGATTACTCA
AATGTAAAACTGCGCTAGGC -> ATGTAAAACTGCGCTAGGCG
AATTAGAGACGCTGCTGTCA -> ATTAGAGACGCTGCTGTCAC
AATTCTTCGAGGGAAGGATG -> ATTCTTCGAGGGAAGGATGG
AATTGCTGCCCTGCGTGCTC -> ATTGCTGCCCTGCGTGCTCA
AATTGTAGTAGTGGCCTGGC -> ATTGTAGTAGTGGCCTGGCA
AATTTACATGATCCTCCATG -> ATTTACATGATCCTCCATGT
ACAAACGTAATTAGAGACGC -> CAAACGTAATTAGAGACGCT
ACAACAGGGTCCCAATGAGT -> CAACAGGGTCCCAATGAGTT
ACAAGACGAAGTGTATAGTA -> CAAGACGAAGTGTATAGTAT
ACAATACCGAAGTTAGAACA -> CAATACCGAAGTTAGAACAT
ACAATTGTAGTAGTGGCCTG -> CAATTGTAGTAGTGGCCTGG
ACAGAAGCTTAAGACTAGGG -> CAGAAGCTTAAGACTAGGGC
ACAGGGTCCCAATGAGTTAC -> CAGGGTCCCAATGAGTTACC
ACAGTCTACTCCGCCTTTCC -> CAGTCTACTCCGCCTTTCCC
ACATGATCCTCCATGTCGAT -> CATGATCCTCCATGTCGATT
ACATTATCTATAGTCAAGTG -> CATTATCTATAGTCAAGTGT
ACCAACCCTAGTCTGGTACT -> CCAACCCTAGTCTGGTACTC
ACCAGGGGTCCGAGACAGAA -> CCAGGGGTCCGAGACAGAAG
ACCAGTCCCGCCTTAAGCGT -> CCAGTCCCGCCTTAAGCGTT
ACCCATATTGCCCTTATGCA -> CCCATATTGCCCTTATGCAA
ACCCCAGGGTGGGCCCACGG -> CCCCAGGGTGGGCCCACGGT
ACCCGAACTTCAAACTCTGG -> CCCGAACTTCAAACTCTGGC
ACCCGACATTATCTATAGTC -> CCCGACATTATCTATAGTCA
ACCCTAGTCTGGTACTCGGG -> CCCTAGTCTGGTACTCGGGC
ACCGAAGTTAGAACATACTA -> CCGAAGTTAGAACATACTAT
ACCGCGGTGTCGGGAGACAA -> CCGCGGTGTCGGGAGACAAT
ACCGGCCCAGGTCGGAATGC -> CCGGCCCAGGTCGGAATGCT
ACCGTTAAAAGCTACAATTG -> CCGTTAAAAGCTACAATTGT
ACCTCACGTTCCCTCTACGA -> CCTCACGTTCCCTCTACGAG
ACCTGTGAAACGCAATAAAT -> CCTGTGAAACGCAATAAATA
ACGAAGTGTATAGTATCAAT -> CGAAGTGTATAGTATCAATA
ACGAATGGGTAGAGAGATTA -> CGAATGGGTAGAGAGATTAC
ACGACCTCACGTTCCCTCTA -> CGACCTCACGTTCCCTCTAC
ACGACGAATGGGTAGAGAGA -> CGACGAATGGGTAGAGAGAT
ACGAGAGACCCATATTGCCC -> CGAGAGACCCATATTGCCCT
ACGAGCAGCACTTGCATAAC -> CGAGCAGCACTTGCATAACC
ACGATGGACGACCTCACGTT -> CGATGGACGACCTCACGTTC
ACGCAATAAATACTGCGCTC -> CGCAATAAATACTGCGCTCA
ACGCGCAGCGCTACTAATAT -> CGCGCAGCGCTACTAATATC
ACGCTAGCGGGCGTCGATTG -> CGCTAGCGGGCGTCGATTGT
ACGCTGCTGTCACCGTTAAA -> CGCTGCTGTCACCGTTAAAA
ACGGAGGACCGGCCCAGGTC -> CGGAGGACCGGCCCAGGTCG
ACGGTTCTTCTTACAGTCTA -> CGGTTCTTCTTACAGTCTAC
ACGTAATTAGAGACGCTGCT -> CGTAATTAGAGACGCTGCTG
ACGTCCGTCCTCACAAACGT -> CGTCCGTCCTCACAAACGTA
ACGTTAGCGGAAAGTACGTC -> CGTTAGCGGAAAGTACGTCC
ACGTTCCCTCTACGAGCAGC -> CGTTCCCTCTACGAGCAGCA
ACTAATATCGACCTGTGAAA -> CTAATATCGACCTGTGAAAC
ACTAGGGCGCTGCTACGAGA -> CTAGGGCGCTGCTACGAGAG
ACTCACTCGCTGGATGGCCG -> CTCACTCGCTGGATGGCCGC
ACTCCGCCTTTCCCGTCTAG -> CTCCGCCTTTCCCGTCTAGC
ACTCCGTGCAGGTGAGCCCC -> CTCCGTGCAGGTGAGCCCCA
ACTCGCTGGATGGCCGCTAA -> CTCGCTGGATGGCCGCTAAC
ACTCGGGCGAATTGCTGCCC -> CTCGGGCGAATTGCTGCCCT
ACTCGGGGGTAAGCATCAGG -> CTCGGGGGTAAGCATCAGGA
ACTCTGGCCCCGTGTTAGAA -> CTCTGGCCCCGTGTTAGAAC
ACTGCGCTAGGCGCTGTACC -> CTGCGCTAGGCGCTGTACCA
ACTGCGCTCAGCTGACAACA -> CTGCGCTCAGCTGACAACAG
ACTGGGCAGATCGGAACCCG -> CTGGGCAGATCGGAACCCGA
ACTTCAAACTCTGGCCCCGT -> CTTCAAACTCTGGCCCCGTG
ACTTGCATAACCCGACATTA -> CTTGCATAACCCGACATTAT
ACTTTGCGACGCGCAGCGCT -> CTTTGCGACGCGCAGCGCTA
AGAACAAGACGAAGTGTATA -> GAACAAGACGAAGTGTATAG
AGAACATACTATCAATTACT -> GAACATACTATCAATTACTT
AGAACGTTAGCGGAAAGTAC -> GAACGTTAGCGGAAAGTACG
AGAAGCTTAAGACTAGGGCG -> GAAGCTTAAGACTAGGGCGC
AGACAATACCGAAGTTAGAA -> GACAATACCGAAGTTAGAAC
AGACAGAAGCTTAAGACTAG -> GACAGAAGCTTAAGACTAGG
AGACCCATATTGCCCTTATG -> GACCCATATTGCCCTTATGC
AGACGAAGTGTATAGTATCA -> GACGAAGTGTATAGTATCAA
AGACGCTGCTGTCACCGTTA -> GACGCTGCTGTCACCGTTAA
AGACTAGGGCGCTGCTACGA -> GACTAGGGCGCTGCTACGAG
AGAGACCCATATTGCCCTTA -> GAGACCCATATTGCCCTTAT
AGAGACGCTGCTGTCACCGT -> GAGACGCTGCTGTCACCGTT
AGAGAGATTACTCACTCGCT -> GAGAGATTACTCACTCGCTG
AGAGATTACTCACTCGCTGG -> GAGATTACTCACTCGCTGGA
AGATCGGAACCCGAACTTCA -> GATCGGAACCCGAACTTCAA
AGATGGTCCAATCACGACGA -> GATGGTCCAATCACGACGAA
AGATTACTCACTCGCTGGAT -> GATTACTCACTCGCTGGATG
AGCACTTGCATAACCCGACA -> GCACTTGCATAACCCGACAT
AGCAGCACTTGCATAACCCG -> GCAGCACTTGCATAACCCGA
AGCATCAGGATGGTATGTAA -> GCATCAGGATGGTATGTAAC
AGCATTTTTCTTTCGGTAAT -> GCATTTTTCTTTCGGTAATT
AGCCACTTTGCGACGCGCAG -> GCCACTTTGCGACGCGCAGC
AGCCAGTACCGCGGTGTCGG -> GCCAGTACCGCGGTGTCGGG
AGCCCCATGGATTAGGAGCC -> GCCCCATGGATTAGGAGCCT
AGCCGAAACTCCGTGCAGGT -> GCCGAAACTCCGTGCAGGTG
AGCCGGGATGTAGTATCGTA -> GCCGGGATGTAGTATCGTAG
AGCCTCGGTACCCCAGGGTG -> GCCTCGGTACCCCAGGGTGG
AGCGCTACTAATATCGACCT -> GCGCTACTAATATCGACCTG
AGCGGAAAGTACGTCCGTCC -> GCGGAAAGTACGTCCGTCCT
AGCGGGCGTCGATTGTGATG -> GCGGGCGTCGATTGTGATGC
AGCGTTAGATGGTCCAATCA -> GCGTTAGATGGTCCAATCAC
AGCTACAATTGTAGTAGTGG -> GCTACAATTGTAGTAGTGGC
AGCTAGTCGTCTTTAGGATT -> GCTAGTCGTCTTTAGGATTG
AGCTGACAACAGGGTCCCAA -> GCTGACAACAGGGTCCCAAT
AGCTTAAGACTAGGGCGCTG -> GCTTAAGACTAGGGCGCTGC
AGGAATTTACATGATCCTCC -> GGAATTTACATGATCCTCCA
AGGACCGGCCCAGGTCGGAA -> GGACCGGCCCAGGTCGGAAT
AGGAGCCTCGGTACCCCAGG -> GGAGCCTCGGTACCCCAGGG
AGGATGGTAAATCGCCACGC -> GGATGGTAAATCGCCACGCT
AGGATGGTATGTAACTGGGC -> GGATGGTATGTAACTGGGCA
AGGATTGCAAATGTAAAACT -> GGATTGCAAATGTAAAACTG
AGGCGCTGTACCAACCCTAG -> GGCGCTGTACCAACCCTAGT
AGGGAAGGATGGTAAATCGC -> GGGAAGGATGGTAAATCGCC
AGGGCGCTGCTACGAGAGAC -> GGGCGCTGCTACGAGAGACC
AGGGGCATTAGAACGTTAGC -> GGGGCATTAGAACGTTAGCG
AGGGGTCCGAGACAGAAGCT -> GGGGTCCGAGACAGAAGCTT
AGGGTCCCAATGAGTTACCA -> GGGTCCCAATGAGTTACCAG
AGGGTGGGCCCACGGTTCTT -> GGGTGGGCCCACGGTTCTTC
AGGTCGGAATGCTCAGCCGA -> GGTCGGAATGCTCAGCCGAA
AGGTGAGCCCCATGGATTAG -> GGTGAGCCCCATGGATTAGG
AGTACCGCGGTGTCGGGAGA -> GTACCGCGGTGTCGGGAGAC
AGTACGTCCGTCCTCACAAA -> GTACGTCCGTCCTCACAAAC
AGTAGTGGCCTGGCAAGCAT -> GTAGTGGCCTGGCAAGCATT
AGTATCAATAAGGAATTTAC -> GTATCAATAAGGAATTTACA
AGTATCGTAGTTCACTCGGG -> GTATCGTAGTTCACTCGGGG
AGTCAAGTGTGAGTGTAGCT -> GTCAAGTGTGAGTGTAGCTA
AGTCCCGCCTTAAGCGTTAG -> GTCCCGCCTTAAGCGTTAGA
AGTCGTCTTTAGGATTGCAA -> GTCGTCTTTAGGATTGCAAA
AGTCTACTCCGCCTTTCCCG -> GTCTACTCCGCCTTTCCCGT
AGTCTATCCGCGTGTAAAGT -> GTCTATCCGCGTGTAAAGTT
AGTCTGGTACTCGGGCGAAT -> GTCTGGTACTCGGGCGAATT
AGTGGCCTGGCAAGCATTTT -> GTGGCCTGGCAAGCATTTTT
AGTGTAGCTAGTCGTCTTTA -> GTGTAGCTAGTCGTCTTTAG
AGTGTATAGTATCAATAAGG -> GTGTATAGTATCAATAAGGA
AGTGTGAGTGTAGCTAGTCG -> GTGTGAGTGTAGCTAGTCGT
AGTTACCAGTCCCGCCTTAA -> GTTACCAGTCCCGCCTTAAG
AGTTAGAACATACTATCAAT -> GTTAGAACATACTATCAATT
AGTTCACTCGGGGGTAAGCA -> GTTCACTCGGGGGTAAGCAT
AGTTTAATCATGCCTCCACC -> GTTTAATCATGCCTCCACCA
ATAAATACTGCGCTCAGCTG -> TAAATACTGCGCTCAGCTGA
ATAACCCGACATTATCTATA -> TAACCCGACATTATCTATAG
ATAAGGAATTTACATGATCC -> TAAGGAATTTACATGATCCT
ATACCGAAGTTAGAACATAC -> TACCGAAGTTAGAACATACT
ATACTGCGCTCAGCTGACAA -> TACTGCGCTCAGCTGACAAC
ATAGTATCAATAAGGAATTT -> TAGTATCAATAAGGAATTTA
ATAGTCAAGTGTGAGTGTAG -> TAGTCAAGTGTGAGTGTAGC
ATATCGACCTGTGAAACGCA -> TATCGACCTGTGAAACGCAA
ATATTGCCCTTATGCAATCA -> TATTGCCCTTATGCAATCAG
ATCAATAAGGAATTTACATG -> TCAATAAGGAATTTACATGA
ATCACGACGAATGGGTAGAG -> TCACGACGAATGGGTAGAGA
ATCAGCCACTTTGCGACGCG -> TCAGCCACTTTGCGACGCGC
ATCAGGATGGTATGTAACTG -> TCAGGATGGTATGTAACTGG
ATCATGCCTCCACCAGGGGT -> TCATGCCTCCACCAGGGGTC
ATCCCCTTCTCGCGGGCGAG -> TCCCCTTCTCGCGGGCGAGC
ATCCGCGTGTAAAGTTTAAT -> TCCGCGTGTAAAGTTTAATC
ATCCTCCATGTCGATTCAGG -> TCCTCCATGTCGATTCAGGG
ATCGACCTGTGAAACGCAAT -> TCGACCTGTGAAACGCAATA
ATCGAGTCTATCCGCGTGTA -> TCGAGTCTATCCGCGTGTAA
ATCGCCACGCTAGCGGGCGT -> TCGCCACGCTAGCGGGCGTC
ATCGGAACCCGAACTTCAAA -> TCGGAACCCGAACTTCAAAC
ATCGTAGTTCACTCGGGGGT -> TCGTAGTTCACTCGGGGGTA
ATCTATAGTCAAGTGTGAGT -> TCTATAGTCAAGTGTGAGTG
ATGAGTTACCAGTCCCGCCT -> TGAGTTACCAGTCCCGCCTT
ATGATCCTCCATGTCGATTC -> TGATCCTCCATGTCGATTCA
ATGCAATCAGCCACTTTGCG -> TGCAATCAGCCACTTTGCGA
ATGCCGTGCGACGATGGACG -> TGCCGTGCGACGATGGACGA
ATGCCTCCACCAGGGGTCCG -> TGCCTCCACCAGGGGTCCGA
ATGCGATCGAGTCTATCCGC -> TGCGATCGAGTCTATCCGCG
ATGCTCAGCCGAAACTCCGT -> TGCTCAGCCGAAACTCCGTG
ATGGACGACCTCACGTTCCC -> TGGACGACCTCACGTTCCCT
ATGGATTAGGAGCCTCGGTA -> TGGATTAGGAGCCTCGGTAC
ATGGCCGCTAACGGAGGACC -> TGGCCGCTAACGGAGGACCG
ATGGGTAGAGAGATTACTCA -> TGGGTAGAGAGATTACTCAC
ATGGTAAATCGCCACGCTAG -> TGGTAAATCGCCACGCTAGC
ATGGTATGTAACTGGGCAGA -> TGGTATGTAACTGGGCAGAT
ATGGTCCAATCACGACGAAT -> TGGTCCAATCACGACGAATG
ATGTAAAACTGCGCTAGGCG -> TGTAAAACTGCGCTAGGCGC
ATGTAACTGGGCAGATCGGA -> TGTAACTGGGCAGATCGGAA
ATGTAGTATCGTAGTTCACT -> TGTAGTATCGTAGTTCACTC
ATGTCGATTCAGGGGCATTA -> TGTCGATTCAGGGGCATTAG
ATTACTCACTCGCTGGATGG -> TTACTCACTCGCTGGATGGC
ATTAGAACGTTAGCGGAAAG -> TTAGAACGTTAGCGGAAAGT
ATTAGAGACGCTGCTGTCAC -> TTAGAGACGCTGCTGTCACC
ATTAGGAGCCTCGGTACCCC -> TTAGGAGCCTCGGTACCCCA
ATTATCTATAGTCAAGTGTG -> TTATCTATAGTCAAGTGTGA
ATTCAGGGGCATTAGAACGT -> TTCAGGGGCATTAGAACGTT
ATTCTTCGAGGGAAGGATGG -> TTCTTCGAGGGAAGGATGGT
ATTGCAAATGTAAAACTGCG -> TTGCAAATGTAAAACTGCGC
ATTGCCCTTATGCAATCAGC -> TTGCCCTTATGCAATCAGCC
ATTGCTGCCCTGCGTGCTCA -> TTGCTGCCCTGCGTGCTCAT
ATTGTAGTAGTGGCCTGGCA -> TTGTAGTAGTGGCCTGGCAA
ATTGTGATGCGATCGAGTCT -> TTGTGATGCGATCGAGTCTA
ATTTACATGATCCTCCATGT -> TTTACATGATCCTCCATGTC
ATTTTTCTTTCGGTAATTCT -> TTTTTCTTTCGGTAATTCTT
CAAACGTAATTAGAGACGCT -> AAACGTAATTAGAGACGCTG
CAAACTCTGGCCCCGTGTTA -> AAACTCTGGCCCCGTGTTAG
CAAATGTAAAACTGCGCTAG -> AAATGTAAAACTGCGCTAGG
CAACAGGGTCCCAATGAGTT -> AACAGGGTCCCAATGAGTTA
CAACCCTAGTCTGGTACTCG -> AACCCTAGTCTGGTACTCGG
CAAGACGAAGTGTATAGTAT -> AAGACGAAGTGTATAGTATC
CAAGCATTTTTCTTTCGGTA -> AAGCATTTTTCTTTCGGTAA
CAAGTGTGAGTGTAGCTAGT -> AAGTGTGAGTGTAGCTAGTC
CAATAAATACTGCGCTCAGC -> AATAAATACTGCGCTCAGCT
CAATAAGGAATTTACATGAT -> AATAAGGAATTTACATGATC
CAATACCGAAGTTAGAACAT -> AATACCGAAGTTAGAACATA
CAATCACGACGAATGGGTAG -> AATCACGACGAATGGGTAGA
CAATCAGCCACTTTGCGACG -> AATCAGCCACTTTGCGACGC
CAATGAGTTACCAGTCCCGC -> AATGAGTTACCAGTCCCGCC
CAATTGTAGTAGTGGCCTGG -> AATTGTAGTAGTGGCCTGGC
CACAAACGTAATTAGAGACG -> ACAAACGTAATTAGAGACGC
CACCAGGGGTCCGAGACAGA -> ACCAGGGGTCCGAGACAGAA
CACCGTTAAAAGCTACAATT -> ACCGTTAAAAGCTACAATTG
CACGACGAATGGGTAGAGAG -> ACGACGAATGGGTAGAGAGA
CACGCTAGCGGGCGTCGATT -> ACGCTAGCGGGCGTCGATTG
CACGGTTCTTCTTACAGTCT -> ACGGTTCTTCTTACAGTCTA
CACGTTCCCTCTACGAGCAG -> ACGTTCCCTCTACGAGCAGC
CACTCGCTGGATGGCCGCTA -> ACTCGCTGGATGGCCGCTAA
CACTCGGGGGTAAGCATCAG -> ACTCGGGGGTAAGCATCAGG
CACTTGCATAACCCGACATT -> ACTTGCATAACCCGACATTA
CACTTTGCGACGCGCAGCGC -> ACTTTGCGACGCGCAGCGCT
CAGAAGCTTAAGACTAGGGC -> AGAAGCTTAAGACTAGGGCG
CAGATCGGAACCCGAACTTC -> AGATCGGAACCCGAACTTCA
CAGCACTTGCATAACCCGAC -> AGCACTTGCATAACCCGACA
CAGCCACTTTGCGACGCGCA -> AGCCACTTTGCGACGCGCAG
CAGCCGAAACTCCGTGCAGG -> AGCCGAAACTCCGTGCAGGT
CAGCGCTACTAATATCGACC -> AGCGCTACTAATATCGACCT
CAGCTGACAACAGGGTCCCA -> AGCTGACAACAGGGTCCCAA
CAGGATGGTATGTAACTGGG -> AGGATGGTATGTAACTGGGC
CAGGGGCATTAGAACGTTAG -> AGGGGCATTAGAACGTTAGC
CAGGGGTCCGAGACAGAAGC -> AGGGGTCCGAGACAGAAGCT
CAGGGTCCCAATGAGTTACC -> AGGGTCCCAATGAGTTACCA
CAGGGTGGGCCCACGGTTCT -> AGGGTGGGCCCACGGTTCTT
CAGGTCGGAATGCTCAGCCG -> AGGTCGGAATGCTCAGCCGA
CAGGTGAGCCCCATGGATTA -> AGGTGAGCCCCATGGATTAG
CAGTACCGCGGTGTCGGGAG -> AGTACCGCGGTGTCGGGAGA
CAGTCCCGCCTTAAGCGTTA -> AGTCCCGCCTTAAGCGTTAG
CAGTCTACTCCGCCTTTCCC -> AGTCTACTCCGCCTTTCCCG
CATAACCCGACATTATCTAT -> ATAACCCGACATTATCTATA
CATATTGCCCTTATGCAATC -> ATATTGCCCTTATGCAATCA
CATCAGGATGGTATGTAACT -> ATCAGGATGGTATGTAACTG
CATCCCCTTCTCGCGGGCGA -> ATCCCCTTCTCGCGGGCGAG
CATGATCCTCCATGTCGATT -> ATGATCCTCCATGTCGATTC
CATGCCTCCACCAGGGGTCC -> ATGCCTCCACCAGGGGTCCG
CATGGATTAGGAGCCTCGGT -> ATGGATTAGGAGCCTCGGTA
CATGTCGATTCAGGGGCATT -> ATGTCGATTCAGGGGCATTA
CATTAGAACGTTAGCGGAAA -> ATTAGAACGTTAGCGGAAAG
CATTATCTATAGTCAAGTGT -> ATTATCTATAGTCAAGTGTG
CATTTTTCTTTCGGTAATTC -> ATTTTTCTTTCGGTAATTCT
CCAACCCTAGTCTGGTACTC -> CAACCCTAGTCTGGTACTCG
CCAATCACGACGAATGGGTA -> CAATCACGACGAATGGGTAG
CCAATGAGTTACCAGTCCCG -> CAATGAGTTACCAGTCCCGC
CCACCAGGGGTCCGAGACAG -> CACCAGGGGTCCGAGACAGA
CCACGCTAGCGGGCGTCGAT -> CACGCTAGCGGGCGTCGATT
CCACGGTTCTTCTTACAGTC -> CACGGTTCTTCTTACAGTCT
CCACTTTGCGACGCGCAGCG -> CACTTTGCGACGCGCAGCGC
CCAGGGGTCCGAGACAGAAG -> CAGGGGTCCGAGACAGAAGC
CCAGGGTGGGCCCACGGTTC -> CAGGGTGGGCCCACGGTTCT
CCAGGTCGGAATGCTCAGCC -> CAGGTCGGAATGCTCAGCCG
CCAGTACCGCGGTGTCGGGA -> CAGTACCGCGGTGTCGGGAG
CCAGTCCCGCCTTAAGCGTT -> CAGTCCCGCCTTAAGCGTTA
CCATATTGCCCTTATGCAAT -> CATATTGCCCTTATGCAATC
CCATGGATTAGGAGCCTCGG -> CATGGATTAGGAGCCTCGGT
CCATGTCGATTCAGGGGCAT -> CATGTCGATTCAGGGGCATT
CCCAATGAGTTACCAGTCCC -> CCAATGAGTTACCAGTCCCG
CCCACGGTTCTTCTTACAGT -> CCACGGTTCTTCTTACAGTC
CCCAGGGTGGGCCCACGGTT -> CCAGGGTGGGCCCACGGTTC
CCCAGGTCGGAATGCTCAGC -> CCAGGTCGGAATGCTCAGCC
CCCATATTGCCCTTATGCAA -> CCATATTGCCCTTATGCAAT
CCCATGGATTAGGAGCCTCG -> CCATGGATTAGGAGCCTCGG
CCCCAGGGTGGGCCCACGGT -> CCCAGGGTGGGCCCACGGTT
CCCCATGGATTAGGAGCCTC -> CCCATGGATTAGGAGCCTCG
CCCCGTGTTAGAACAAGACG -> CCCGTGTTAGAACAAGACGA
CCCCTTCTCGCGGGCGAGCC -> CCCTTCTCGCGGGCGAGCCG
CCCGAACTTCAAACTCTGGC -> CCGAACTTCAAACTCTGGCC
CCCGACATTATCTATAGTCA -> CCGACATTATCTATAGTCAA
CCCGCCTTAAGCGTTAGATG -> CCGCCTTAAGCGTTAGATGG
CCCGTCTAGCCAGTACCGCG -> CCGTCTAGCCAGTACCGCGG
CCCGTGTTAGAACAAGACGA -> CCGTGTTAGAACAAGACGAA
CCCTAGTCTGGTACTCGGGC -> CCTAGTCTGGTACTCGGGCG
CCCTCTACGAGCAGCACTTG -> CCTCTACGAGCAGCACTTGC
CCCTGCGTGCTCATCCCCTT -> CCTGCGTGCTCATCCCCTTC
CCCTTATGCAATCAGCCACT -> CCTTATGCAATCAGCCACTT
CCCTTCTCGCGGGCGAGCCG -> CCTTCTCGCGGGCGAGCCGG
CCGAAACTCCGTGCAGGTGA -> CGAAACTCCGTGCAGGTGAG
CCGAACTTCAAACTCTGGCC -> CGAACTTCAAACTCTGGCCC
CCGAAGTTAGAACATACTAT -> CGAAGTTAGAACATACTATC
CCGACATTATCTATAGTCAA -> CGACATTATCTATAGTCAAG
CCGAGACAGAAGCTTAAGAC -> CGAGACAGAAGCTTAAGACT
CCGCCTTAAGCGTTAGATGG -> CGCCTTAAGCGTTAGATGGT
CCGCCTTTCCCGTCTAGCCA -> CGCCTTTCCCGTCTAGCCAG
CCGCGGTGTCGGGAGACAAT -> CGCGGTGTCGGGAGACAATA
CCGCGTGTAAAGTTTAATCA -> CGCGTGTAAAGTTTAATCAT
CCGCTAACGGAGGACCGGCC -> CGCTAACGGAGGACCGGCCC
CCGGCCCAGGTCGGAATGCT -> CGGCCCAGGTCGGAATGCTC
CCGGGATGTAGTATCGTAGT -> CGGGATGTAGTATCGTAGTT
CCGTCCTCACAAACGTAATT -> CGTCCTCACAAACGTAATTA
CCGTCTAGCCAGTACCGCGG -> CGTCTAGCCAGTACCGCGGT
CCGTGCAGGTGAGCCCCATG -> CGTGCAGGTGAGCCCCATGG
CCGTGCGACGATGGACGACC -> CGTGCGACGATGGACGACCT
CCGTGTTAGAACAAGACGAA -> CGTGTTAGAACAAGACGAAG
CCGTTAAAAGCTACAATTGT -> CGTTAAAAGCTACAATTGTA
CCTAGTCTGGTACTCGGGCG -> CTAGTCTGGTACTCGGGCGA
CCTCACAAACGTAATTAGAG -> CTCACAAACGTAATTAGAGA
CCTCACGTTCCCTCTACGAG -> CTCACGTTCCCTCTACGAGC
CCTCCACCAGGGGTCCGAGA -> CTCCACCAGGGGTCCGAGAC
CCTCCATGTCGATTCAGGGG -> CTCCATGTCGATTCAGGGGC
CCTCGGTACCCCAGGGTGGG -> CTCGGTACCCCAGGGTGGGC
CCTCTACGAGCAGCACTTGC -> CTCTACGAGCAGCACTTGCA
CCTGCGTGCTCATCCCCTTC -> CTGCGTGCTCATCCCCTTCT
CCTGGCAAGCATTTTTCTTT -> CTGGCAAGCATTTTTCTTTC
CCTGTGAAACGCAATAAATA -> CTGTGAAACGCAATAAATAC
CCTTAAGCGTTAGATGGTCC -> CTTAAGCGTTAGATGGTCCA
CCTTATGCAATCAGCCACTT -> CTTATGCAATCAGCCACTTT
CCTTCTCGCGGGCGAGCCGG -> CTTCTCGCGGGCGAGCCGGG
CCTTTCCCGTCTAGCCAGTA -> CTTTCCCGTCTAGCCAGTAC
CGAAACTCCGTGCAGGTGAG -> GAAACTCCGTGCAGGTGAGC
CGAACTTCAAACTCTGGCCC -> GAACTTCAAACTCTGGCCCC
CGAAGTGTATAGTATCAATA -> GAAGTGTATAGTATCAATAA
CGAAGTTAGAACATACTATC -> GAAGTTAGAACATACTATCA
CGAATGGGTAGAGAGATTAC -> GAATGGGTAGAGAGATTACT
CGAATTGCTGCCCTGCGTGC -> GAATTGCTGCCCTGCGTGCT
CGACATTATCTATAGTCAAG -> GACATTATCTATAGTCAAGT
CGACCTCACGTTCCCTCTAC -> GACCTCACGTTCCCTCTACG
CGACCTGTGAAACGCAATAA -> GACCTGTGAAACGCAATAAA
CGACGAATGGGTAGAGAGAT -> GACGAATGGGTAGAGAGATT
CGACGATGGACGACCTCACG -> GACGATGGACGACCTCACGT
CGACGCGCAGCGCTACTAAT -> GACGCGCAGCGCTACTAATA
CGAGACAGAAGCTTAAGACT -> GAGACAGAAGCTTAAGACTA
CGAGAGACCCATATTGCCCT -> GAGAGACCCATATTGCCCTT
CGAGCAGCACTTGCATAACC -> GAGCAGCACTTGCATAACCC
CGAGCCGGGATGTAGTATCG -> GAGCCGGGATGTAGTATCGT
CGAGGGAAGGATGGTAAATC -> GAGGGAAGGATGGTAAATCG
CGAGTCTATCCGCGTGTAAA -> GAGTCTATCCGCGTGTAAAG
CGATCGAGTCTATCCGCGTG -> GATCGAGTCTATCCGCGTGT
CGATGGACGACCTCACGTTC -> GATGGACGACCTCACGTTCC
CGATTCAGGGGCATTAGAAC -> GATTCAGGGGCATTAGAACG
CGATTGTGATGCGATCGAGT -> GATTGTGATGCGATCGAGTC
CGCAATAAATACTGCGCTCA -> GCAATAAATACTGCGCTCAG
CGCAGCGCTACTAATATCGA -> GCAGCGCTACTAATATCGAC
CGCCACGCTAGCGGGCGTCG -> GCCACGCTAGCGGGCGTCGA
CGCCTTAAGCGTTAGATGGT -> GCCTTAAGCGTTAGATGGTC
CGCCTTTCCCGTCTAGCCAG -> GCCTTTCCCGTCTAGCCAGT
CGCGCAGCGCTACTAATATC -> GCGCAGCGCTACTAATATCG
CGCGGGCGAGCCGGGATGTA -> GCGGGCGAGCCGGGATGTAG
CGCGGTGTCGGGAGACAATA -> GCGGTGTCGGGAGACAATAC
CGCGTGTAAAGTTTAATCAT -> GCGTGTAAAGTTTAATCATG
CGCTAACGGAGGACCGGCCC -> GCTAACGGAGGACCGGCCCA
CGCTACTAATATCGACCTGT -> GCTACTAATATCGACCTGTG
CGCTAGCGGGCGTCGATTGT -> GCTAGCGGGCGTCGATTGTG
CGCTAGGCGCTGTACCAACC -> GCTAGGCGCTGTACCAACCC
CGCTCAGCTGACAACAGGGT -> GCTCAGCTGACAACAGGGTC
CGCTGCTACGAGAGACCCAT -> GCTGCTACGAGAGACCCATA
CGCTGCTGTCACCGTTAAAA -> GCTGCTGTCACCGTTAAAAG
CGCTGGATGGCCGCTAACGG -> GCTGGATGGCCGCTAACGGA
CGCTGTACCAACCCTAGTCT -> GCTGTACCAACCCTAGTCTG
CGGAAAGTACGTCCGTCCTC -> GGAAAGTACGTCCGTCCTCA
CGGAACCCGAACTTCAAACT -> GGAACCCGAACTTCAAACTC
CGGAATGCTCAGCCGAAACT -> GGAATGCTCAGCCGAAACTC
CGGAGGACCGGCCCAGGTCG -> GGAGGACCGGCCCAGGTCGG
CGGCCCAGGTCGGAATGCTC -> GGCCCAGGTCGGAATGCTCA
CGGGAGACAATACCGAAGTT -> GGGAGACAATACCGAAGTTA
CGGGATGTAGTATCGTAGTT -> GGGATGTAGTATCGTAGTTC
CGGGCGAATTGCTGCCCTGC -> GGGCGAATTGCTGCCCTGCG
CGGGCGAGCCGGGATGTAGT -> GGGCGAGCCGGGATGTAGTA
CGGGCGTCGATTGTGATGCG -> GGGCGTCGATTGTGATGCGA
CGGGGGTAAGCATCAGGATG -> GGGGGTAAGCATCAGGATGG
CGGTAATTCTTCGAGGGAAG -> GGTAATTCTTCGAGGGAAGG
CGGTACCCCAGGGTGGGCCC -> GGTACCCCAGGGTGGGCCCA
CGGTGATGCCGTGCGACGAT -> GGTGATGCCGTGCGACGATG
CGGTGTCGGGAGACAATACC -> GGTGTCGGGAGACAATACCG
CGGTTCTTCTTACAGTCTAC -> GGTTCTTCTTACAGTCTACT
CGTAATTAGAGACGCTGCTG -> GTAATTAGAGACGCTGCTGT
CGTAGTTCACTCGGGGGTAA -> GTAGTTCACTCGGGGGTAAG
CGTCCGTCCTCACAAACGTA -> GTCCGTCCTCACAAACGTAA
CGTCCTCACAAACGTAATTA -> GTCCTCACAAACGTAATTAG
CGTCGATTGTGATGCGATCG -> GTCGATTGTGATGCGATCGA
CGTCTAGCCAGTACCGCGGT -> GTCTAGCCAGTACCGCGGTG
CGTCTTTAGGATTGCAAATG -> GTCTTTAGGATTGCAAATGT
CGTGCAGGTGAGCCCCATGG -> GTGCAGGTGAGCCCCATGGA
CGTGCGACGATGGACGACCT -> GTGCGACGATGGACGACCTC
CGTGCTCATCCCCTTCTCGC -> GTGCTCATCCCCTTCTCGCG
CGTGTAAAGTTTAATCATGC -> GTGTAAAGTTTAATCATGCC
CGTGTTAGAACAAGACGAAG -> GTGTTAGAACAAGACGAAGT
CGTTAAAAGCTACAATTGTA -> GTTAAAAGCTACAATTGTAG
CGTTAGATGGTCCAATCACG -> GTTAGATGGTCCAATCACGA
CGTTAGCGGAAAGTACGTCC -> GTTAGCGGAAAGTACGTCCG
CGTTCCCTCTACGAGCAGCA -> GTTCCCTCTACGAGCAGCAC
CTAACGGAGGACCGGCCCAG -> TAACGGAGGACCGGCCCAGG
CTAATATCGACCTGTGAAAC -> TAATATCGACCTGTGAAACG
CTACAATTGTAGTAGTGGCC -> TACAATTGTAGTAGTGGCCT
CTACGAGAGACCCATATTGC -> TACGAGAGACCCATATTGCC
CTACGAGCAGCACTTGCATA -> TACGAGCAGCACTTGCATAA
CTACTAATATCGACCTGTGA -> TACTAATATCGACCTGTGAA
CTACTCCGCCTTTCCCGTCT -> TACTCCGCCTTTCCCGTCTA
CTAGCCAGTACCGCGGTGTC -> TAGCCAGTACCGCGGTGTCG
CTAGCGGGCGTCGATTGTGA -> TAGCGGGCGTCGATTGTGAT
CTAGGCGCTGTACCAACCCT -> TAGGCGCTGTACCAACCCTA
CTAGGGCGCTGCTACGAGAG -> TAGGGCGCTGCTACGAGAGA
CTAGTCGTCTTTAGGATTGC -> TAGTCGTCTTTAGGATTGCA
CTAGTCTGGTACTCGGGCGA -> TAGTCTGGTACTCGGGCGAA
CTATAGTCAAGTGTGAGTGT -> TATAGTCAAGTGTGAGTGTA
CTATCCGCGTGTAAAGTTTA -> TATCCGCGTGTAAAGTTTAA
CTCACAAACGTAATTAGAGA -> TCACAAACGTAATTAGAGAC
CTCACGTTCCCTCTACGAGC -> TCACGTTCCCTCTACGAGCA
CTCACTCGCTGGATGGCCGC -> TCACTCGCTGGATGGCCGCT
CTCAGCCGAAACTCCGTGCA -> TCAGCCGAAACTCCGTGCAG
CTCAGCTGACAACAGGGTCC -> TCAGCTGACAACAGGGTCCC
CTCATCCCCTTCTCGCGGGC -> TCATCCCCTTCTCGCGGGCG
CTCCACCAGGGGTCCGAGAC -> TCCACCAGGGGTCCGAGACA
CTCCATGTCGATTCAGGGGC -> TCCATGTCGATTCAGGGGCA
CTCCGCCTTTCCCGTCTAGC -> TCCGCCTTTCCCGTCTAGCC
CTCCGTGCAGGTGAGCCCCA -> TCCGTGCAGGTGAGCCCCAT
CTCGCGGGCGAGCCGGGATG -> TCGCGGGCGAGCCGGGATGT
CTCGCTGGATGGCCGCTAAC -> TCGCTGGATGGCCGCTAACG
CTCGGGCGAATTGCTGCCCT -> TCGGGCGAATTGCTGCCCTG
CTCGGGGGTAAGCATCAGGA -> TCGGGGGTAAGCATCAGGAT
CTCGGTACCCCAGGGTGGGC -> TCGGTACCCCAGGGTGGGCC
CTCTACGAGCAGCACTTGCA -> TCTACGAGCAGCACTTGCAT
CTCTGGCCCCGTGTTAGAAC -> TCTGGCCCCGTGTTAGAACA
CTGACAACAGGGTCCCAATG -> TGACAACAGGGTCCCAATGA
CTGCCCTGCGTGCTCATCCC -> TGCCCTGCGTGCTCATCCCC
CTGCGCTAGGCGCTGTACCA -> TGCGCTAGGCGCTGTACCAA
CTGCGCTCAGCTGACAACAG -> TGCGCTCAGCTGACAACAGG
CTGCGTGCTCATCCCCTTCT -> TGCGTGCTCATCCCCTTCTC
CTGCTACGAGAGACCCATAT -> TGCTACGAGAGACCCATATT
CTGCTGTCACCGTTAAAAGC -> TGCTGTCACCGTTAAAAGCT
CTGGATGGCCGCTAACGGAG -> TGGATGGCCGCTAACGGAGG
CTGGCAAGCATTTTTCTTTC -> TGGCAAGCATTTTTCTTTCG
CTGGCCCCGTGTTAGAACAA -> TGGCCCCGTGTTAGAACAAG
CTGGGCAGATCGGAACCCGA -> TGGGCAGATCGGAACCCGAA
CTGGTACTCGGGCGAATTGC -> TGGTACTCGGGCGAATTGCT
CTGTACCAACCCTAGTCTGG -> TGTACCAACCCTAGTCTGGT
CTGTCACCGTTAAAAGCTAC -> TGTCACCGTTAAAAGCTACA
CTGTGAAACGCAATAAATAC -> TGTGAAACGCAATAAATACT
CTTAAGACTAGGGCGCTGCT -> TTAAGACTAGGGCGCTGCTA
CTTAAGCGTTAGATGGTCCA -> TTAAGCGTTAGATGGTCCAA
CTTACAGTCTACTCCGCCTT -> TTACAGTCTACTCCGCCTTT
CTTATGCAATCAGCCACTTT -> TTATGCAATCAGCCACTTTG
CTTCAAACTCTGGCCCCGTG -> TTCAAACTCTGGCCCCGTGT
CTTCGAGGGAAGGATGGTAA -> TTCGAGGGAAGGATGGTAAA
CTTCTCGCGGGCGAGCCGGG -> TTCTCGCGGGCGAGCCGGGA
CTTCTTACAGTCTACTCCGC -> TTCTTACAGTCTACTCCGCC
CTTGCATAACCCGACATTAT -> TTGCATAACCCGACATTATC
CTTTAGGATTGCAAATGTAA -> TTTAGGATTGCAAATGTAAA
CTTTCCCGTCTAGCCAGTAC -> TTTCCCGTCTAGCCAGTACC
CTTTCGGTAATTCTTCGAGG -> TTTCGGTAATTCTTCGAGGG
CTTTGCGACGCGCAGCGCTA -> TTTGCGACGCGCAGCGCTAC
GAAACGCAATAAATACTGCG -> AAACGCAATAAATACTGCGC
GAAACTCCGTGCAGGTGAGC -> AAACTCCGTGCAGGTGAGCC
GAAAGTACGTCCGTCCTCAC -> AAAGTACGTCCGTCCTCACA
GAACAAGACGAAGTGTATAG -> AACAAGACGAAGTGTATAGT
GAACCCGAACTTCAAACTCT -> AACCCGAACTTCAAACTCTG
GAACGTTAGCGGAAAGTACG -> AACGTTAGCGGAAAGTACGT
GAACTTCAAACTCTGGCCCC -> AACTTCAAACTCTGGCCCCG
GAAGCTTAAGACTAGGGCGC -> AAGCTTAAGACTAGGGCGCT
GAAGGATGGTAAATCGCCAC -> AAGGATGGTAAATCGCCACG
GAAGTGTATAGTATCAATAA -> AAGTGTATAGTATCAATAAG
GAAGTTAGAACATACTATCA -> AAGTTAGAACATACTATCAA
GAATGCTCAGCCGAAACTCC -> AATGCTCAGCCGAAACTCCG
GAATGGGTAGAGAGATTACT -> AATGGGTAGAGAGATTACTC
GAATTGCTGCCCTGCGTGCT -> AATTGCTGCCCTGCGTGCTC
GAATTTACATGATCCTCCAT -> AATTTACATGATCCTCCATG
GACAACAGGGTCCCAATGAG -> ACAACAGGGTCCCAATGAGT
GACAATACCGAAGTTAGAAC -> ACAATACCGAAGTTAGAACA
GACAGAAGCTTAAGACTAGG -> ACAGAAGCTTAAGACTAGGG
GACATTATCTATAGTCAAGT -> ACATTATCTATAGTCAAGTG
GACCCATATTGCCCTTATGC -> ACCCATATTGCCCTTATGCA
GACCGGCCCAGGTCGGAATG -> ACCGGCCCAGGTCGGAATGC
GACCTCACGTTCCCTCTACG -> ACCTCACGTTCCCTCTACGA
GACCTGTGAAACGCAATAAA -> ACCTGTGAAACGCAATAAAT
GACGAAGTGTATAGTATCAA -> ACGAAGTGTATAGTATCAAT
GACGAATGGGTAGAGAGATT -> ACGAATGGGTAGAGAGATTA
GACGACCTCACGTTCCCTCT -> ACGACCTCACGTTCCCTCTA
GACGATGGACGACCTCACGT -> ACGATGGACGACCTCACGTT
GACGCGCAGCGCTACTAATA -> ACGCGCAGCGCTACTAATAT
GACGCTGCTGTCACCGTTAA -> ACGCTGCTGTCACCGTTAAA
GACTAGGGCGCTGCTACGAG -> ACTAGGGCGCTGCTACGAGA
GAGACAATACCGAAGTTAGA -> AGACAATACCGAAGTTAGAA
GAGACAGAAGCTTAAGACTA -> AGACAGAAGCTTAAGACTAG
GAGACCCATATTGCCCTTAT -> AGACCCATATTGCCCTTATG
GAGACGCTGCTGTCACCGTT -> AGACGCTGCTGTCACCGTTA
GAGAGACCCATATTGCCCTT -> AGAGACCCATATTGCCCTTA
GAGAGATTACTCACTCGCTG -> AGAGATTACTCACTCGCTGG
GAGATTACTCACTCGCTGGA -> AGATTACTCACTCGCTGGAT
GAGCAGCACTTGCATAACCC -> AGCAGCACTTGCATAACCCG
GAGCCCCATGGATTAGGAGC -> AGCCCCATGGATTAGGAGCC
GAGCCGGGATGTAGTATCGT -> AGCCGGGATGTAGTATCGTA
GAGCCTCGGTACCCCAGGGT -> AGCCTCGGTACCCCAGGGTG
GAGGACCGGCCCAGGTCGGA -> AGGACCGGCCCAGGTCGGAA
GAGGGAAGGATGGTAAATCG -> AGGGAAGGATGGTAAATCGC
GAGTCTATCCGCGTGTAAAG -> AGTCTATCCGCGTGTAAAGT
GAGTGTAGCTAGTCGTCTTT -> AGTGTAGCTAGTCGTCTTTA
GAGTTACCAGTCCCGCCTTA -> AGTTACCAGTCCCGCCTTAA
GATCCTCCATGTCGATTCAG -> ATCCTCCATGTCGATTCAGG
GATCGAGTCTATCCGCGTGT -> ATCGAGTCTATCCGCGTGTA
GATCGGAACCCGAACTTCAA -> ATCGGAACCCGAACTTCAAA
GATGCCGTGCGACGATGGAC -> ATGCCGTGCGACGATGGACG
GATGCGATCGAGTCTATCCG -> ATGCGATCGAGTCTATCCGC
GATGGACGACCTCACGTTCC -> ATGGACGACCTCACGTTCCC
GATGGCCGCTAACGGAGGAC -> ATGGCCGCTAACGGAGGACC
GATGGTAAATCGCCACGCTA -> ATGGTAAATCGCCACGCTAG
GATGGTATGTAACTGGGCAG -> ATGGTATGTAACTGGGCAGA
GATGGTCCAATCACGACGAA -> ATGGTCCAATCACGACGAAT
GATGTAGTATCGTAGTTCAC -> ATGTAGTATCGTAGTTCACT
GATTACTCACTCGCTGGATG -> ATTACTCACTCGCTGGATGG
GATTAGGAGCCTCGGTACCC -> ATTAGGAGCCTCGGTACCCC
GATTCAGGGGCATTAGAACG -> ATTCAGGGGCATTAGAACGT
GATTGCAAATGTAAAACTGC -> ATTGCAAATGTAAAACTGCG
GATTGTGATGCGATCGAGTC -> ATTGTGATGCGATCGAGTCT
GCAAATGTAAAACTGCGCTA -> CAAATGTAAAACTGCGCTAG
GCAAGCATTTTTCTTTCGGT -> CAAGCATTTTTCTTTCGGTA
GCAATAAATACTGCGCTCAG -> CAATAAATACTGCGCTCAGC
GCAATCAGCCACTTTGCGAC -> CAATCAGCCACTTTGCGACG
GCACTTGCATAACCCGACAT -> CACTTGCATAACCCGACATT
GCAGATCGGAACCCGAACTT -> CAGATCGGAACCCGAACTTC
GCAGCACTTGCATAACCCGA -> CAGCACTTGCATAACCCGAC
GCAGCGCTACTAATATCGAC -> CAGCGCTACTAATATCGACC
GCAGGTGAGCCCCATGGATT -> CAGGTGAGCCCCATGGATTA
GCATAACCCGACATTATCTA -> CATAACCCGACATTATCTAT
GCATCAGGATGGTATGTAAC -> CATCAGGATGGTATGTAACT
GCATTAGAACGTTAGCGGAA -> CATTAGAACGTTAGCGGAAA
GCATTTTTCTTTCGGTAATT -> CATTTTTCTTTCGGTAATTC
GCCACGCTAGCGGGCGTCGA -> CCACGCTAGCGGGCGTCGAT
GCCACTTTGCGACGCGCAGC -> CCACTTTGCGACGCGCAGCG
GCCAGTACCGCGGTGTCGGG -> CCAGTACCGCGGTGTCGGGA
GCCCACGGTTCTTCTTACAG -> CCCACGGTTCTTCTTACAGT
GCCCAGGTCGGAATGCTCAG -> CCCAGGTCGGAATGCTCAGC
GCCCCATGGATTAGGAGCCT -> CCCCATGGATTAGGAGCCTC
GCCCCGTGTTAGAACAAGAC -> CCCCGTGTTAGAACAAGACG
GCCCTGCGTGCTCATCCCCT -> CCCTGCGTGCTCATCCCCTT
GCCCTTATGCAATCAGCCAC -> CCCTTATGCAATCAGCCACT
GCCGAAACTCCGTGCAGGTG -> CCGAAACTCCGTGCAGGTGA
GCCGCTAACGGAGGACCGGC -> CCGCTAACGGAGGACCGGCC
GCCGGGATGTAGTATCGTAG -> CCGGGATGTAGTATCGTAGT
GCCGTGCGACGATGGACGAC -> CCGTGCGACGATGGACGACC
GCCTCCACCAGGGGTCCGAG -> CCTCCACCAGGGGTCCGAGA
GCCTCGGTACCCCAGGGTGG -> CCTCGGTACCCCAGGGTGGG
GCCTGGCAAGCATTTTTCTT -> CCTGGCAAGCATTTTTCTTT
GCCTTAAGCGTTAGATGGTC -> CCTTAAGCGTTAGATGGTCC
GCCTTTCCCGTCTAGCCAGT -> CCTTTCCCGTCTAGCCAGTA
GCGAATTGCTGCCCTGCGTG -> CGAATTGCTGCCCTGCGTGC
GCGACGATGGACGACCTCAC -> CGACGATGGACGACCTCACG
GCGACGCGCAGCGCTACTAA -> CGACGCGCAGCGCTACTAAT
GCGAGCCGGGATGTAGTATC -> CGAGCCGGGATGTAGTATCG
GCGATCGAGTCTATCCGCGT -> CGATCGAGTCTATCCGCGTG
GCGCAGCGCTACTAATATCG -> CGCAGCGCTACTAATATCGA
GCGCTACTAATATCGACCTG -> CGCTACTAATATCGACCTGT
GCGCTAGGCGCTGTACCAAC -> CGCTAGGCGCTGTACCAACC
GCGCTCAGCTGACAACAGGG -> CGCTCAGCTGACAACAGGGT
GCGCTGCTACGAGAGACCCA -> CGCTGCTACGAGAGACCCAT
GCGCTGTACCAACCCTAGTC -> CGCTGTACCAACCCTAGTCT
GCGGAAAGTACGTCCGTCCT -> CGGAAAGTACGTCCGTCCTC
GCGGGCGAGCCGGGATGTAG -> CGGGCGAGCCGGGATGTAGT
GCGGGCGTCGATTGTGATGC -> CGGGCGTCGATTGTGATGCG
GCGGTGATGCCGTGCGACGA -> CGGTGATGCCGTGCGACGAT
GCGGTGTCGGGAGACAATAC -> CGGTGTCGGGAGACAATACC
GCGTCGATTGTGATGCGATC -> CGTCGATTGTGATGCGATCG
GCGTGCTCATCCCCTTCTCG -> CGTGCTCATCCCCTTCTCGC
GCGTGTAAAGTTTAATCATG -> CGTGTAAAGTTTAATCATGC
GCGTTAGATGGTCCAATCAC -> CGTTAGATGGTCCAATCACG
GCTAACGGAGGACCGGCCCA -> CTAACGGAGGACCGGCCCAG
GCTACAATTGTAGTAGTGGC -> CTACAATTGTAGTAGTGGCC
GCTACGAGAGACCCATATTG -> CTACGAGAGACCCATATTGC
GCTACTAATATCGACCTGTG -> CTACTAATATCGACCTGTGA
GCTAGCGGGCGTCGATTGTG -> CTAGCGGGCGTCGATTGTGA
GCTAGGCGCTGTACCAACCC -> CTAGGCGCTGTACCAACCCT
GCTAGTCGTCTTTAGGATTG -> CTAGTCGTCTTTAGGATTGC
GCTCAGCCGAAACTCCGTGC -> CTCAGCCGAAACTCCGTGCA
GCTCAGCTGACAACAGGGTC -> CTCAGCTGACAACAGGGTCC
GCTCATCCCCTTCTCGCGGG -> CTCATCCCCTTCTCGCGGGC
GCTGACAACAGGGTCCCAAT -> CTGACAACAGGGTCCCAATG
GCTGCCCTGCGTGCTCATCC -> CTGCCCTGCGTGCTCATCCC
GCTGCTACGAGAGACCCATA -> CTGCTACGAGAGACCCATAT
GCTGCTGTCACCGTTAAAAG -> CTGCTGTCACCGTTAAAAGC
GCTGGATGGCCGCTAACGGA -> CTGGATGGCCGCTAACGGAG
GCTGTACCAACCCTAGTCTG -> CTGTACCAACCCTAGTCTGG
GCTGTCACCGTTAAAAGCTA -> CTGTCACCGTTAAAAGCTAC
GCTTAAGACTAGGGCGCTGC -> CTTAAGACTAGGGCGCTGCT
GGAAAGTACGTCCGTCCTCA -> GAAAGTACGTCCGTCCTCAC
GGAACCCGAACTTCAAACTC -> GAACCCGAACTTCAAACTCT
GGAAGGATGGTAAATCGCCA -> GAAGGATGGTAAATCGCCAC
GGAATGCTCAGCCGAAACTC -> GAATGCTCAGCCGAAACTCC
GGAATTTACATGATCCTCCA -> GAATTTACATGATCCTCCAT
GGACCGGCCCAGGTCGGAAT -> GACCGGCCCAGGTCGGAATG
GGACGACCTCACGTTCCCTC -> GACGACCTCACGTTCCCTCT
GGAGACAATACCGAAGTTAG -> GAGACAATACCGAAGTTAGA
GGAGCCTCGGTACCCCAGGG -> GAGCCTCGGTACCCCAGGGT
GGAGGACCGGCCCAGGTCGG -> GAGGACCGGCCCAGGTCGGA
GGATGGCCGCTAACGGAGGA -> GATGGCCGCTAACGGAGGAC
GGATGGTAAATCGCCACGCT -> GATGGTAAATCGCCACGCTA
GGATGGTATGTAACTGGGCA -> GATGGTATGTAACTGGGCAG
GGATGTAGTATCGTAGTTCA -> GATGTAGTATCGTAGTTCAC
GGATTAGGAGCCTCGGTACC -> GATTAGGAGCCTCGGTACCC
GGATTGCAAATGTAAAACTG -> GATTGCAAATGTAAAACTGC
GGCAAGCATTTTTCTTTCGG -> GCAAGCATTTTTCTTTCGGT
GGCAGATCGGAACCCGAACT -> GCAGATCGGAACCCGAACTT
GGCATTAGAACGTTAGCGGA -> GCATTAGAACGTTAGCGGAA
GGCCCACGGTTCTTCTTACA -> GCCCACGGTTCTTCTTACAG
GGCCCAGGTCGGAATGCTCA -> GCCCAGGTCGGAATGCTCAG
GGCCCCGTGTTAGAACAAGA -> GCCCCGTGTTAGAACAAGAC
GGCCGCTAACGGAGGACCGG -> GCCGCTAACGGAGGACCGGC
GGCCTGGCAAGCATTTTTCT -> GCCTGGCAAGCATTTTTCTT
GGCGAATTGCTGCCCTGCGT -> GCGAATTGCTGCCCTGCGTG
GGCGAGCCGGGATGTAGTAT -> GCGAGCCGGGATGTAGTATC
GGCGCTGCTACGAGAGACCC -> GCGCTGCTACGAGAGACCCA
GGCGCTGTACCAACCCTAGT -> GCGCTGTACCAACCCTAGTC
GGCGTCGATTGTGATGCGAT -> GCGTCGATTGTGATGCGATC
GGGAAGGATGGTAAATCGCC -> GGAAGGATGGTAAATCGCCA
GGGAGACAATACCGAAGTTA -> GGAGACAATACCGAAGTTAG
GGGATGTAGTATCGTAGTTC -> GGATGTAGTATCGTAGTTCA
GGGCAGATCGGAACCCGAAC -> GGCAGATCGGAACCCGAACT
GGGCATTAGAACGTTAGCGG -> GGCATTAGAACGTTAGCGGA
GGGCCCACGGTTCTTCTTAC -> GGCCCACGGTTCTTCTTACA
GGGCGAATTGCTGCCCTGCG -> GGCGAATTGCTGCCCTGCGT
GGGCGAGCCGGGATGTAGTA -> GGCGAGCCGGGATGTAGTAT
GGGCGCTGCTACGAGAGACC -> GGCGCTGCTACGAGAGACCC
GGGCGTCGATTGTGATGCGA -> GGCGTCGATTGTGATGCGAT
GGGGCATTAGAACGTTAGCG -> GGGCATTAGAACGTTAGCGG
GGGGGTAAGCATCAGGATGG -> GGGGTAAGCATCAGGATGGT
GGGGTAAGCATCAGGATGGT -> GGGTAAGCATCAGGATGGTA
GGGGTCCGAGACAGAAGCTT -> GGGTCCGAGACAGAAGCTTA
GGGTAAGCATCAGGATGGTA -> GGTAAGCATCAGGATGGTAT
GGGTAGAGAGATTACTCACT -> GGTAGAGAGATTACTCACTC
GGGTCCCAATGAGTTACCAG -> GGTCCCAATGAGTTACCAGT
GGGTCCGAGACAGAAGCTTA -> GGTCCGAGACAGAAGCTTAA
GGGTGGGCCCACGGTTCTTC -> GGTGGGCCCACGGTTCTTCT
GGTAAATCGCCACGCTAGCG -> GTAAATCGCCACGCTAGCGG
GGTAAGCATCAGGATGGTAT -> GTAAGCATCAGGATGGTATG
GGTAATTCTTCGAGGGAAGG -> GTAATTCTTCGAGGGAAGGA
GGTACCCCAGGGTGGGCCCA -> GTACCCCAGGGTGGGCCCAC
GGTACTCGGGCGAATTGCTG -> GTACTCGGGCGAATTGCTGC
GGTAGAGAGATTACTCACTC -> GTAGAGAGATTACTCACTCG
GGTATGTAACTGGGCAGATC -> GTATGTAACTGGGCAGATCG
GGTCCAATCACGACGAATGG -> GTCCAATCACGACGAATGGG
GGTCCCAATGAGTTACCAGT -> GTCCCAATGAGTTACCAGTC
GGTCCGAGACAGAAGCTTAA -> GTCCGAGACAGAAGCTTAAG
GGTCGGAATGCTCAGCCGAA -> GTCGGAATGCTCAGCCGAAA
GGTGAGCCCCATGGATTAGG -> GTGAGCCCCATGGATTAGGA
GGTGATGCCGTGCGACGATG -> GTGATGCCGTGCGACGATGG
GGTGGGCCCACGGTTCTTCT -> GTGGGCCCACGGTTCTTCTT
GGTGTCGGGAGACAATACCG -> GTGTCGGGAGACAATACCGA
GGTTCTTCTTACAGTCTACT -> GTTCTTCTTACAGTCTACTC
GTAAAACTGCGCTAGGCGCT -> TAAAACTGCGCTAGGCGCTG
GTAAAGTTTAATCATGCCTC -> TAAAGTTTAATCATGCCTCC
GTAAATCGCCACGCTAGCGG -> TAAATCGCCACGCTAGCGGG
GTAACTGGGCAGATCGGAAC -> TAACTGGGCAGATCGGAACC
GTAAGCATCAGGATGGTATG -> TAAGCATCAGGATGGTATGT
GTAATTAGAGACGCTGCTGT -> TAATTAGAGACGCTGCTGTC
GTAATTCTTCGAGGGAAGGA -> TAATTCTTCGAGGGAAGGAT
GTACCAACCCTAGTCTGGTA -> TACCAACCCTAGTCTGGTAC
GTACCCCAGGGTGGGCCCAC -> TACCCCAGGGTGGGCCCACG
GTACCGCGGTGTCGGGAGAC -> TACCGCGGTGTCGGGAGACA
GTACGTCCGTCCTCACAAAC -> TACGTCCGTCCTCACAAACG
GTACTCGGGCGAATTGCTGC -> TACTCGGGCGAATTGCTGCC
GTAGAGAGATTACTCACTCG -> TAGAGAGATTACTCACTCGC
GTAGCTAGTCGTCTTTAGGA -> TAGCTAGTCGTCTTTAGGAT
GTAGTAGTGGCCTGGCAAGC -> TAGTAGTGGCCTGGCAAGCA
GTAGTATCGTAGTTCACTCG -> TAGTATCGTAGTTCACTCGG
GTAGTGGCCTGGCAAGCATT -> TAGTGGCCTGGCAAGCATTT
GTAGTTCACTCGGGGGTAAG -> TAGTTCACTCGGGGGTAAGC
GTATAGTATCAATAAGGAAT -> TATAGTATCAATAAGGAATT
GTATCAATAAGGAATTTACA -> TATCAATAAGGAATTTACAT
GTATCGTAGTTCACTCGGGG -> TATCGTAGTTCACTCGGGGG
GTATGTAACTGGGCAGATCG -> TATGTAACTGGGCAGATCGG
GTCAAGTGTGAGTGTAGCTA -> TCAAGTGTGAGTGTAGCTAG
GTCACCGTTAAAAGCTACAA -> TCACCGTTAAAAGCTACAAT
GTCCAATCACGACGAATGGG -> TCCAATCACGACGAATGGGT
GTCCCAATGAGTTACCAGTC -> TCCCAATGAGTTACCAGTCC
GTCCCGCCTTAAGCGTTAGA -> TCCCGCCTTAAGCGTTAGAT
GTCCGAGACAGAAGCTTAAG -> TCCGAGACAGAAGCTTAAGA
GTCCGTCCTCACAAACGTAA -> TCCGTCCTCACAAACGTAAT
GTCCTCACAAACGTAATTAG -> TCCTCACAAACGTAATTAGA
GTCGATTCAGGGGCATTAGA -> TCGATTCAGGGGCATTAGAA
GTCGATTGTGATGCGATCGA -> TCGATTGTGATGCGATCGAG
GTCGGAATGCTCAGCCGAAA -> TCGGAATGCTCAGCCGAAAC
GTCGGGAGACAATACCGAAG -> TCGGGAGACAATACCGAAGT
GTCGTCTTTAGGATTGCAAA -> TCGTCTTTAGGATTGCAAAT
GTCTACTCCGCCTTTCCCGT -> TCTACTCCGCCTTTCCCGTC
GTCTAGCCAGTACCGCGGTG -> TCTAGCCAGTACCGCGGTGT
GTCTATCCGCGTGTAAAGTT -> TCTATCCGCGTGTAAAGTTT
GTCTGGTACTCGGGCGAATT -> TCTGGTACTCGGGCGAATTG
GTCTTTAGGATTGCAAATGT -> TCTTTAGGATTGCAAATGTA
GTGAAACGCAATAAATACTG -> TGAAACGCAATAAATACTGC
GTGAGCCCCATGGATTAGGA -> TGAGCCCCATGGATTAGGAG
GTGAGTGTAGCTAGTCGTCT -> TGAGTGTAGCTAGTCGTCTT
GTGATGCCGTGCGACGATGG -> TGATGCCGTGCGACGATGGA
GTGATGCGATCGAGTCTATC -> TGATGCGATCGAGTCTATCC
GTGCAGGTGAGCCCCATGGA -> TGCAGGTGAGCCCCATGGAT
GTGCGACGATGGACGACCTC -> TGCGACGATGGACGACCTCA
GTGCTCATCCCCTTCTCGCG -> TGCTCATCCCCTTCTCGCGG
GTGGCCTGGCAAGCATTTTT -> TGGCCTGGCAAGCATTTTTC
GTGGGCCCACGGTTCTTCTT -> TGGGCCCACGGTTCTTCTTA
GTGTAAAGTTTAATCATGCC -> TGTAAAGTTTAATCATGCCT
GTGTAGCTAGTCGTCTTTAG -> TGTAGCTAGTCGTCTTTAGG
GTGTATAGTATCAATAAGGA -> TGTATAGTATCAATAAGGAA
GTGTCGGGAGACAATACCGA -> TGTCGGGAGACAATACCGAA
GTGTGAGTGTAGCTAGTCGT -> TGTGAGTGTAGCTAGTCGTC
GTGTTAGAACAAGACGAAGT -> TGTTAGAACAAGACGAAGTG
GTTAAAAGCTACAATTGTAG -> TTAAAAGCTACAATTGTAGT
GTTACCAGTCCCGCCTTAAG -> TTACCAGTCCCGCCTTAAGC
GTTAGAACAAGACGAAGTGT -> TTAGAACAAGACGAAGTGTA
GTTAGAACATACTATCAATT -> TTAGAACATACTATCAATTA
GTTAGATGGTCCAATCACGA -> TTAGATGGTCCAATCACGAC
GTTAGCGGAAAGTACGTCCG -> TTAGCGGAAAGTACGTCCGT
GTTCACTCGGGGGTAAGCAT -> TTCACTCGGGGGTAAGCATC
GTTCCCTCTACGAGCAGCAC -> TTCCCTCTACGAGCAGCACT
GTTCTTCTTACAGTCTACTC -> TTCTTCTTACAGTCTACTCC
GTTTAATCATGCCTCCACCA -> TTTAATCATGCCTCCACCAG
TAAAACTGCGCTAGGCGCTG -> AAAACTGCGCTAGGCGCTGT
TAAAAGCTACAATTGTAGTA -> AAAAGCTACAATTGTAGTAG
TAAAGTTTAATCATGCCTCC -> AAAGTTTAATCATGCCTCCA
TAAATACTGCGCTCAGCTGA -> AAATACTGCGCTCAGCTGAC
TAAATCGCCACGCTAGCGGG -> AAATCGCCACGCTAGCGGGC
TAACCCGACATTATCTATAG -> AACCCGACATTATCTATAGT
TAACGGAGGACCGGCCCAGG -> AACGGAGGACCGGCCCAGGT
TAACTGGGCAGATCGGAACC -> AACTGGGCAGATCGGAACCC
TAAGACTAGGGCGCTGCTAC -> AAGACTAGGGCGCTGCTACG
TAAGCATCAGGATGGTATGT -> AAGCATCAGGATGGTATGTA
TAAGCGTTAGATGGTCCAAT -> AAGCGTTAGATGGTCCAATC
TAAGGAATTTACATGATCCT -> AAGGAATTTACATGATCCTC
TAATATCGACCTGTGAAACG -> AATATCGACCTGTGAAACGC
TAATCATGCCTCCACCAGGG -> AATCATGCCTCCACCAGGGG
TAATTAGAGACGCTGCTGTC -> AATTAGAGACGCTGCTGTCA
TAATTCTTCGAGGGAAGGAT -> AATTCTTCGAGGGAAGGATG
TACAATTGTAGTAGTGGCCT -> ACAATTGTAGTAGTGGCCTG
TACAGTCTACTCCGCCTTTC -> ACAGTCTACTCCGCCTTTCC
TACATGATCCTCCATGTCGA -> ACATGATCCTCCATGTCGAT
TACCAACCCTAGTCTGGTAC -> ACCAACCCTAGTCTGGTACT
TACCAGTCCCGCCTTAAGCG -> ACCAGTCCCGCCTTAAGCGT
TACCCCAGGGTGGGCCCACG -> ACCCCAGGGTGGGCCCACGG
TACCGAAGTTAGAACATACT -> ACCGAAGTTAGAACATACTA
TACCGCGGTGTCGGGAGACA -> ACCGCGGTGTCGGGAGACAA
TACGAGAGACCCATATTGCC -> ACGAGAGACCCATATTGCCC
TACGAGCAGCACTTGCATAA -> ACGAGCAGCACTTGCATAAC
TACGTCCGTCCTCACAAACG -> ACGTCCGTCCTCACAAACGT
TACTAATATCGACCTGTGAA -> ACTAATATCGACCTGTGAAA
TACTCACTCGCTGGATGGCC -> ACTCACTCGCTGGATGGCCG
TACTCCGCCTTTCCCGTCTA -> ACTCCGCCTTTCCCGTCTAG
TACTCGGGCGAATTGCTGCC -> ACTCGGGCGAATTGCTGCCC
TACTGCGCTCAGCTGACAAC -> ACTGCGCTCAGCTGACAACA
TAGAACAAGACGAAGTGTAT -> AGAACAAGACGAAGTGTATA
TAGAACATACTATCAATTAC -> AGAACATACTATCAATTACT
TAGAACGTTAGCGGAAAGTA -> AGAACGTTAGCGGAAAGTAC
TAGAGACGCTGCTGTCACCG -> AGAGACGCTGCTGTCACCGT
TAGAGAGATTACTCACTCGC -> AGAGAGATTACTCACTCGCT
TAGATGGTCCAATCACGACG -> AGATGGTCCAATCACGACGA
TAGCCAGTACCGCGGTGTCG -> AGCCAGTACCGCGGTGTCGG
TAGCGGAAAGTACGTCCGTC -> AGCGGAAAGTACGTCCGTCC
TAGCGGGCGTCGATTGTGAT -> AGCGGGCGTCGATTGTGATG
TAGCTAGTCGTCTTTAGGAT -> AGCTAGTCGTCTTTAGGATT
TAGGAGCCTCGGTACCCCAG -> AGGAGCCTCGGTACCCCAGG
TAGGATTGCAAATGTAAAAC -> AGGATTGCAAATGTAAAACT
TAGGCGCTGTACCAACCCTA -> AGGCGCTGTACCAACCCTAG
TAGGGCGCTGCTACGAGAGA -> AGGGCGCTGCTACGAGAGAC
TAGTAGTGGCCTGGCAAGCA -> AGTAGTGGCCTGGCAAGCAT
TAGTATCAATAAGGAATTTA -> AGTATCAATAAGGAATTTAC
TAGTATCGTAGTTCACTCGG -> AGTATCGTAGTTCACTCGGG
TAGTCAAGTGTGAGTGTAGC -> AGTCAAGTGTGAGTGTAGCT
TAGTCGTCTTTAGGATTGCA -> AGTCGTCTTTAGGATTGCAA
TAGTCTGGTACTCGGGCGAA -> AGTCTGGTACTCGGGCGAAT
TAGTGGCCTGGCAAGCATTT -> AGTGGCCTGGCAAGCATTTT
TAGTTCACTCGGGGGTAAGC -> AGTTCACTCGGGGGTAAGCA
TATAGTATCAATAAGGAATT -> ATAGTATCAATAAGGAATTT
TATAGTCAAGTGTGAGTGTA -> ATAGTCAAGTGTGAGTGTAG
TATCAATAAGGAATTTACAT -> ATCAATAAGGAATTTACATG
TATCCGCGTGTAAAGTTTAA -> ATCCGCGTGTAAAGTTTAAT
TATCGACCTGTGAAACGCAA -> ATCGACCTGTGAAACGCAAT
TATCGTAGTTCACTCGGGGG -> ATCGTAGTTCACTCGGGGGT
TATCTATAGTCAAGTGTGAG -> ATCTATAGTCAAGTGTGAGT
TATGCAATCAGCCACTTTGC -> ATGCAATCAGCCACTTTGCG
TATGTAACTGGGCAGATCGG -> ATGTAACTGGGCAGATCGGA
TATTGCCCTTATGCAATCAG -> ATTGCCCTTATGCAATCAGC
TCAAACTCTGGCCCCGTGTT -> CAAACTCTGGCCCCGTGTTA
TCAAGTGTGAGTGTAGCTAG -> CAAGTGTGAGTGTAGCTAGT
TCAATAAGGAATTTACATGA -> CAATAAGGAATTTACATGAT
TCACAAACGTAATTAGAGAC -> CACAAACGTAATTAGAGACG
TCACCGTTAAAAGCTACAAT -> CACCGTTAAAAGCTACAATT
TCACGACGAATGGGTAGAGA -> CACGACGAATGGGTAGAGAG
TCACGTTCCCTCTACGAGCA -> CACGTTCCCTCTACGAGCAG
TCACTCGCTGGATGGCCGCT -> CACTCGCTGGATGGCCGCTA
TCACTCGGGGGTAAGCATCA -> CACTCGGGGGTAAGCATCAG
TCAGCCACTTTGCGACGCGC -> CAGCCACTTTGCGACGCGCA
TCAGCCGAAACTCCGTGCAG -> CAGCCGAAACTCCGTGCAGG
TCAGCTGACAACAGGGTCCC -> CAGCTGACAACAGGGTCCCA
TCAGGATGGTATGTAACTGG -> CAGGATGGTATGTAACTGGG
TCAGGGGCATTAGAACGTTA -> CAGGGGCATTAGAACGTTAG
TCATCCCCTTCTCGCGGGCG -> CATCCCCTTCTCGCGGGCGA
TCATGCCTCCACCAGGGGTC -> CATGCCTCCACCAGGGGTCC
TCCAATCACGACGAATGGGT -> CCAATCACGACGAATGGGTA
TCCACCAGGGGTCCGAGACA -> CCACCAGGGGTCCGAGACAG
TCCATGTCGATTCAGGGGCA -> CCATGTCGATTCAGGGGCAT
TCCCAATGAGTTACCAGTCC -> CCCAATGAGTTACCAGTCCC
TCCCCTTCTCGCGGGCGAGC -> CCCCTTCTCGCGGGCGAGCC
TCCCGCCTTAAGCGTTAGAT -> CCCGCCTTAAGCGTTAGATG
TCCCGTCTAGCCAGTACCGC -> CCCGTCTAGCCAGTACCGCG
TCCCTCTACGAGCAGCACTT -> CCCTCTACGAGCAGCACTTG
TCCGAGACAGAAGCTTAAGA -> CCGAGACAGAAGCTTAAGAC
TCCGCCTTTCCCGTCTAGCC -> CCGCCTTTCCCGTCTAGCCA
TCCGCGTGTAAAGTTTAATC -> CCGCGTGTAAAGTTTAATCA
TCCGTCCTCACAAACGTAAT -> CCGTCCTCACAAACGTAATT
TCCGTGCAGGTGAGCCCCAT -> CCGTGCAGGTGAGCCCCATG
TCCTCACAAACGTAATTAGA -> CCTCACAAACGTAATTAGAG
TCCTCCATGTCGATTCAGGG -> CCTCCATGTCGATTCAGGGG
TCGACCTGTGAAACGCAATA -> CGACCTGTGAAACGCAATAA
TCGAGGGAAGGATGGTAAAT -> CGAGGGAAGGATGGTAAATC
TCGAGTCTATCCGCGTGTAA -> CGAGTCTATCCGCGTGTAAA
TCGATTCAGGGGCATTAGAA -> CGATTCAGGGGCATTAGAAC
TCGATTGTGATGCGATCGAG -> CGATTGTGATGCGATCGAGT
TCGCCACGCTAGCGGGCGTC -> CGCCACGCTAGCGGGCGTCG
TCGCGGGCGAGCCGGGATGT -> CGCGGGCGAGCCGGGATGTA
TCGCTGGATGGCCGCTAACG -> CGCTGGATGGCCGCTAACGG
TCGGAACCCGAACTTCAAAC -> CGGAACCCGAACTTCAAACT
TCGGAATGCTCAGCCGAAAC -> CGGAATGCTCAGCCGAAACT
TCGGGAGACAATACCGAAGT -> CGGGAGACAATACCGAAGTT
TCGGGCGAATTGCTGCCCTG -> CGGGCGAATTGCTGCCCTGC
TCGGGGGTAAGCATCAGGAT -> CGGGGGTAAGCATCAGGATG
TCGGTAATTCTTCGAGGGAA -> CGGTAATTCTTCGAGGGAAG
TCGGTACCCCAGGGTGGGCC -> CGGTACCCCAGGGTGGGCCC
TCGTAGTTCACTCGGGGGTA -> CGTAGTTCACTCGGGGGTAA
TCGTCTTTAGGATTGCAAAT -> CGTCTTTAGGATTGCAAATG
TCTACGAGCAGCACTTGCAT -> CTACGAGCAGCACTTGCATA
TCTACTCCGCCTTTCCCGTC -> CTACTCCGCCTTTCCCGTCT
TCTAGCCAGTACCGCGGTGT -> CTAGCCAGTACCGCGGTGTC
TCTATAGTCAAGTGTGAGTG -> CTATAGTCAAGTGTGAGTGT
TCTATCCGCGTGTAAAGTTT -> CTATCCGCGTGTAAAGTTTA
TCTCGCGGGCGAGCCGGGAT -> CTCGCGGGCGAGCCGGGATG
TCTGGCCCCGTGTTAGAACA -> CTGGCCCCGTGTTAGAACAA
TCTGGTACTCGGGCGAATTG -> CTGGTACTCGGGCGAATTGC
TCTTACAGTCTACTCCGCCT -> CTTACAGTCTACTCCGCCTT
TCTTCGAGGGAAGGATGGTA -> CTTCGAGGGAAGGATGGTAA
TCTTCTTACAGTCTACTCCG -> CTTCTTACAGTCTACTCCGC
TCTTTAGGATTGCAAATGTA -> CTTTAGGATTGCAAATGTAA
TCTTTCGGTAATTCTTCGAG -> CTTTCGGTAATTCTTCGAGG
TGAAACGCAATAAATACTGC -> GAAACGCAATAAATACTGCG
TGACAACAGGGTCCCAATGA -> GACAACAGGGTCCCAATGAG
TGAGCCCCATGGATTAGGAG -> GAGCCCCATGGATTAGGAGC
TGAGTGTAGCTAGTCGTCTT -> GAGTGTAGCTAGTCGTCTTT
TGAGTTACCAGTCCCGCCTT -> GAGTTACCAGTCCCGCCTTA
TGATCCTCCATGTCGATTCA -> GATCCTCCATGTCGATTCAG
TGATGCCGTGCGACGATGGA -> GATGCCGTGCGACGATGGAC
TGATGCGATCGAGTCTATCC -> GATGCGATCGAGTCTATCCG
TGCAAATGTAAAACTGCGCT -> GCAAATGTAAAACTGCGCTA
TGCAATCAGCCACTTTGCGA -> GCAATCAGCCACTTTGCGAC
TGCAGGTGAGCCCCATGGAT -> GCAGGTGAGCCCCATGGATT
TGCATAACCCGACATTATCT -> GCATAACCCGACATTATCTA
TGCCCTGCGTGCTCATCCCC -> GCCCTGCGTGCTCATCCCCT
TGCCCTTATGCAATCAGCCA -> GCCCTTATGCAATCAGCCAC
TGCCGTGCGACGATGGACGA -> GCCGTGCGACGATGGACGAC
TGCCTCCACCAGGGGTCCGA -> GCCTCCACCAGGGGTCCGAG
TGCGACGATGGACGACCTCA -> GCGACGATGGACGACCTCAC
TGCGACGCGCAGCGCTACTA -> GCGACGCGCAGCGCTACTAA
TGCGATCGAGTCTATCCGCG -> GCGATCGAGTCTATCCGCGT
TGCGCTAGGCGCTGTACCAA -> GCGCTAGGCGCTGTACCAAC
TGCGCTCAGCTGACAACAGG -> GCGCTCAGCTGACAACAGGG
TGCGTGCTCATCCCCTTCTC -> GCGTGCTCATCCCCTTCTCG
TGCTACGAGAGACCCATATT -> GCTACGAGAGACCCATATTG
TGCTCAGCCGAAACTCCGTG -> GCTCAGCCGAAACTCCGTGC
TGCTCATCCCCTTCTCGCGG -> GCTCATCCCCTTCTCGCGGG
TGCTGCCCTGCGTGCTCATC -> GCTGCCCTGCGTGCTCATCC
TGCTGTCACCGTTAAAAGCT -> GCTGTCACCGTTAAAAGCTA
TGGACGACCTCACGTTCCCT -> GGACGACCTCACGTTCCCTC
TGGATGGCCGCTAACGGAGG -> GGATGGCCGCTAACGGAGGA
TGGATTAGGAGCCTCGGTAC -> GGATTAGGAGCCTCGGTACC
TGGCAAGCATTTTTCTTTCG -> GGCAAGCATTTTTCTTTCGG
TGGCCCCGTGTTAGAACAAG -> GGCCCCGTGTTAGAACAAGA
TGGCCGCTAACGGAGGACCG -> GGCCGCTAACGGAGGACCGG
TGGCCTGGCAAGCATTTTTC -> GGCCTGGCAAGCATTTTTCT
TGGGCAGATCGGAACCCGAA -> GGGCAGATCGGAACCCGAAC
TGGGCCCACGGTTCTTCTTA -> GGGCCCACGGTTCTTCTTAC
TGGGTAGAGAGATTACTCAC -> GGGTAGAGAGATTACTCACT
TGGTAAATCGCCACGCTAGC -> GGTAAATCGCCACGCTAGCG
TGGTACTCGGGCGAATTGCT -> GGTACTCGGGCGAATTGCTG
TGGTATGTAACTGGGCAGAT -> GGTATGTAACTGGGCAGATC
TGGTCCAATCACGACGAATG -> GGTCCAATCACGACGAATGG
TGTAAAACTGCGCTAGGCGC -> GTAAAACTGCGCTAGGCGCT
TGTAAAGTTTAATCATGCCT -> GTAAAGTTTAATCATGCCTC
TGTAACTGGGCAGATCGGAA -> GTAACTGGGCAGATCGGAAC
TGTACCAACCCTAGTCTGGT -> GTACCAACCCTAGTCTGGTA
TGTAGCTAGTCGTCTTTAGG -> GTAGCTAGTCGTCTTTAGGA
TGTAGTAGTGGCCTGGCAAG -> GTAGTAGTGGCCTGGCAAGC
TGTAGTATCGTAGTTCACTC -> GTAGTATCGTAGTTCACTCG
TGTATAGTATCAATAAGGAA -> GTATAGTATCAATAAGGAAT
TGTCACCGTTAAAAGCTACA -> GTCACCGTTAAAAGCTACAA
TGTCGATTCAGGGGCATTAG -> GTCGATTCAGGGGCATTAGA
TGTCGGGAGACAATACCGAA -> GTCGGGAGACAATACCGAAG
TGTGAAACGCAATAAATACT -> GTGAAACGCAATAAATACTG
TGTGAGTGTAGCTAGTCGTC -> GTGAGTGTAGCTAGTCGTCT
TGTGATGCGATCGAGTCTAT -> GTGATGCGATCGAGTCTATC
TGTTAGAACAAGACGAAGTG -> GTTAGAACAAGACGAAGTGT
TTAAAAGCTACAATTGTAGT -> TAAAAGCTACAATTGTAGTA
TTAAGACTAGGGCGCTGCTA -> TAAGACTAGGGCGCTGCTAC
TTAAGCGTTAGATGGTCCAA -> TAAGCGTTAGATGGTCCAAT
TTAATCATGCCTCCACCAGG -> TAATCATGCCTCCACCAGGG
TTACAGTCTACTCCGCCTTT -> TACAGTCTACTCCGCCTTTC
TTACATGATCCTCCATGTCG -> TACATGATCCTCCATGTCGA
TTACCAGTCCCGCCTTAAGC -> TACCAGTCCCGCCTTAAGCG
TTACTCACTCGCTGGATGGC -> TACTCACTCGCTGGATGGCC
TTAGAACAAGACGAAGTGTA -> TAGAACAAGACGAAGTGTAT
TTAGAACATACTATCAATTA -> TAGAACATACTATCAATTAC
TTAGAACGTTAGCGGAAAGT -> TAGAACGTTAGCGGAAAGTA
TTAGAGACGCTGCTGTCACC -> TAGAGACGCTGCTGTCACCG
TTAGATGGTCCAATCACGAC -> TAGATGGTCCAATCACGACG
TTAGCGGAAAGTACGTCCGT -> TAGCGGAAAGTACGTCCGTC
TTAGGAGCCTCGGTACCCCA -> TAGGAGCCTCGGTACCCCAG
TTAGGATTGCAAATGTAAAA -> TAGGATTGCAAATGTAAAAC
TTATCTATAGTCAAGTGTGA -> TATCTATAGTCAAGTGTGAG
TTATGCAATCAGCCACTTTG -> TATGCAATCAGCCACTTTGC
TTCAAACTCTGGCCCCGTGT -> TCAAACTCTGGCCCCGTGTT
TTCACTCGGGGGTAAGCATC -> TCACTCGGGGGTAAGCATCA
TTCAGGGGCATTAGAACGTT -> TCAGGGGCATTAGAACGTTA
TTCCCGTCTAGCCAGTACCG -> TCCCGTCTAGCCAGTACCGC
TTCCCTCTACGAGCAGCACT -> TCCCTCTACGAGCAGCACTT
TTCGAGGGAAGGATGGTAAA -> TCGAGGGAAGGATGGTAAAT
TTCGGTAATTCTTCGAGGGA -> TCGGTAATTCTTCGAGGGAA
TTCTCGCGGGCGAGCCGGGA -> TCTCGCGGGCGAGCCGGGAT
TTCTTACAGTCTACTCCGCC -> TCTTACAGTCTACTCCGCCT
TTCTTCGAGGGAAGGATGGT -> TCTTCGAGGGAAGGATGGTA
TTCTTCTTACAGTCTACTCC -> TCTTCTTACAGTCTACTCCG
TTCTTTCGGTAATTCTTCGA -> TCTTTCGGTAATTCTTCGAG
TTGCAAATGTAAAACTGCGC -> TGCAAATGTAAAACTGCGCT
TTGCATAACCCGACATTATC -> TGCATAACCCGACATTATCT
TTGCCCTTATGCAATCAGCC -> TGCCCTTATGCAATCAGCCA
TTGCGACGCGCAGCGCTACT -> TGCGACGCGCAGCGCTACTA
TTGCTGCCCTGCGTGCTCAT -> TGCTGCCCTGCGTGCTCATC
TTGTAGTAGTGGCCTGGCAA -> TGTAGTAGTGGCCTGGCAAG
TTGTGATGCGATCGAGTCTA -> TGTGATGCGATCGAGTCTAT
TTTAATCATGCCTCCACCAG -> TTAATCATGCCTCCACCAGG
TTTACATGATCCTCCATGTC -> TTACATGATCCTCCATGTCG
TTTAGGATTGCAAATGTAAA -> TTAGGATTGCAAATGTAAAA
TTTCCCGTCTAGCCAGTACC -> TTCCCGTCTAGCCAGTACCG
TTTCGGTAATTCTTCGAGGG -> TTCGGTAATTCTTCGAGGGA
TTTCTTTCGGTAATTCTTCG -> TTCTTTCGGTAATTCTTCGA
TTTGCGACGCGCAGCGCTAC -> TTGCGACGCGCAGCGCTACT
TTTTCTTTCGGTAATTCTTC -> TTTCTTTCGGTAATTCTTCG
TTTTTCTTTCGGTAATTCTT -> TTTTCTTTCGGTAATTCTTC
