AAAAAATAAGAGGCCGAAG -> AAAAATAAGAGGCCGAAGA
AAAAACCAACTATCCTGAT -> AAAACCAACTATCCTGATC
AAAAATAAGAGGCCGAAGA -> AAAATAAGAGGCCGAAGAT
AAAACCAACTATCCTGATC -> AAACCAACTATCCTGATCA
AAAACTTTAGGGGGTCTGT -> AAACTTTAGGGGGTCTGTA
AAAAGGAGATGTATGTCAC -> AAAGGAGATGTATGTCACG
AAAAGTCTGAACTACAGTG -> AAAGTCTGAACTACAGTGT
AAAAGTTACCCCGTCGGAG -> AAAGTTACCCCGTCGGAGG
AAAATAAGAGGCCGAAGAT -> AAATAAGAGGCCGAAGATG
AAAATCGCCGCGTGAGAGA -> AAATCGCCGCGTGAGAGAA
AAAATGACCCAGCATCAGG -> AAATGACCCAGCATCAGGC
AAAATGATAAAGGAGCAAA -> AAATGATAAAGGAGCAAAA
AAAATTCAAATCACGGATG -> AAATTCAAATCACGGATGC
AAAATTCTGGTTGCTGTAG -> AAATTCTGGTTGCTGTAGC
AAACAATACACTGAAGGAG -> AACAATACACTGAAGGAGG
AAACCAACTATCCTGATCA -> AACCAACTATCCTGATCAA
AAACGGTCTTGAGCTGTGA -> AACGGTCTTGAGCTGTGAA
AAACGTTGTGTCTTCCGAC -> AACGTTGTGTCTTCCGACT
AAACTGCTAGACATTGGTG -> AACTGCTAGACATTGGTGT
AAACTTTAGGGGGTCTGTA -> AACTTTAGGGGGTCTGTAC
AAAGAAACGTTGTGTCTTC -> AAGAAACGTTGTGTCTTCC
AAAGACCCATATGACTGCT -> AAGACCCATATGACTGCTC
AAAGAGGGCTACACCGAGA -> AAGAGGGCTACACCGAGAA
AAAGCAGACACTTCGATTA -> AAGCAGACACTTCGATTAG
AAAGCAGTCCTGCACGGTA -> AAGCAGTCCTGCACGGTAG
AAAGGAGATGTATGTCACG -> AAGGAGATGTATGTCACGC
AAAGGAGCAAAATTCAAAT -> AAGGAGCAAAATTCAAATC
AAAGTCTGAACTACAGTGT -> AAGTCTGAACTACAGTGTC
AAAGTTAAAAAATAAGAGG -> AAGTTAAAAAATAAGAGGC
AAAGTTACCCCGTCGGAGG -> AAGTTACCCCGTCGGAGGG
AAAGTTTTGATCCAGAGTG -> AAGTTTTGATCCAGAGTGC
AAATAACTGGTCCGGTTCC -> AATAACTGGTCCGGTTCCG
AAATAAGAGGCCGAAGATG -> AATAAGAGGCCGAAGATGT
AAATCACGGATGCCACTCG -> AATCACGGATGCCACTCGC
AAATCCTACGACAGCGGCT -> AATCCTACGACAGCGGCTT
AAATCGCCCTACTAAGGTT -> AATCGCCCTACTAAGGTTA
AAATCGCCGCGTGAGAGAA -> AATCGCCGCGTGAGAGAAA
AAATGACCCAGCATCAGGC -> AATGACCCAGCATCAGGCG
AAATGATAAAGGAGCAAAA -> AATGATAAAGGAGCAAAAT
AAATTCAAATCACGGATGC -> AATTCAAATCACGGATGCC
AAATTCTGGTTGCTGTAGC -> AATTCTGGTTGCTGTAGCT
AAATTTGGAAAGAAACGTT -> AATTTGGAAAGAAACGTTG
AACAATACACTGAAGGAGG -> ACAATACACTGAAGGAGGA
AACACTGTCATAGGGACGT -> ACACTGTCATAGGGACGTC
AACCAACTATCCTGATCAA -> ACCAACTATCCTGATCAAT
AACCACTCCCCCGCCTTTA -> ACCACTCCCCCGCCTTTAT
AACCCGTAGCCTCCGGGTC -> ACCCGTAGCCTCCGGGTCA
AACCTGGTTGCTATGCTCA -> ACCTGGTTGCTATGCTCAG
AACCTGTGGCGGTTGCATT -> ACCTGTGGCGGTTGCATTA
AACGATATTCAGATTCGTT -> ACGATATTCAGATTCGTTC
AACGCACGCTTTCAGACCA -> ACGCACGCTTTCAGACCAG
AACGCATCTAGTCTACGTA -> ACGCATCTAGTCTACGTAT
AACGCTCCGTTAGAACCCG -> ACGCTCCGTTAGAACCCGT
AACGCTCTGTAGGCGCTCC -> ACGCTCTGTAGGCGCTCCG
AACGGTCTTGAGCTGTGAA -> ACGGTCTTGAGCTGTGAAA
AACGTAAGAGCTGATCTAG -> ACGTAAGAGCTGATCTAGG
AACGTTGTGTCTTCCGACT -> ACGTTGTGTCTTCCGACTT
AACTACAGTGTCTCCTCTA -> ACTACAGTGTCTCCTCTAA
AACTACCATCGAAAACTTT -> ACTACCATCGAAAACTTTA
AACTATCCTGATCAATGCA -> ACTATCCTGATCAATGCAC
AACTGCTAGACATTGGTGT -> ACTGCTAGACATTGGTGTA
AACTGGTCCGGTTCCGACA -> ACTGGTCCGGTTCCGACAC
AACTGGTCCTGGCCACGCA -> ACTGGTCCTGGCCACGCAG
AACTTCAGTTACTTAGCCC -> ACTTCAGTTACTTAGCCCG
AACTTTAGGGGGTCTGTAC -> ACTTTAGGGGGTCTGTACT
AAGAAAAACCAACTATCCT -> AGAAAAACCAACTATCCTG
AAGAAACGTTGTGTCTTCC -> AGAAACGTTGTGTCTTCCG
AAGAAGGCCACTTGTACAA -> AGAAGGCCACTTGTACAAT
AAGAAGTGGCTCGCATTAG -> AGAAGTGGCTCGCATTAGT
AAGACACGAATGAATGACT -> AGACACGAATGAATGACTC
AAGACCCATATGACTGCTC -> AGACCCATATGACTGCTCG
AAGACCCCAGTTTTAAATC -> AGACCCCAGTTTTAAATCC
AAGAGCGAAATTTGGAAAG -> AGAGCGAAATTTGGAAAGA
AAGAGCTGATCTAGGACTC -> AGAGCTGATCTAGGACTCT
AAGAGGCCCCGCACGTTTG -> AGAGGCCCCGCACGTTTGG
AAGAGGCCGAAGATGTATT -> AGAGGCCGAAGATGTATTA
AAGAGGGCTACACCGAGAA -> AGAGGGCTACACCGAGAAC
AAGATCCGAGAAAGCAGAC -> AGATCCGAGAAAGCAGACA
AAGATGTATTAACCTGTGG -> AGATGTATTAACCTGTGGC
AAGCAGACACTTCGATTAG -> AGCAGACACTTCGATTAGC
AAGCAGTCCTGCACGGTAG -> AGCAGTCCTGCACGGTAGT
AAGCCAGTTTAATCTGTAA -> AGCCAGTTTAATCTGTAAG
AAGCTGGCGCCGGCTGATA -> AGCTGGCGCCGGCTGATAT
AAGGAAAATTCTGGTTGCT -> AGGAAAATTCTGGTTGCTG
AAGGACTTCGGTAGAATTA -> AGGACTTCGGTAGAATTAC
AAGGAGATGTATGTCACGC -> AGGAGATGTATGTCACGCA
AAGGAGCAAAATTCAAATC -> AGGAGCAAAATTCAAATCA
AAGGAGGAGATGCGCACAC -> AGGAGGAGATGCGCACACC
AAGGCCACTTGTACAATTC -> AGGCCACTTGTACAATTCA
AAGGGAGGCTACGCACAGT -> AGGGAGGCTACGCACAGTG
AAGGGCAATTGGTCTTTCC -> AGGGCAATTGGTCTTTCCA
AAGGTCGGGCCACCGTTCA -> AGGTCGGGCCACCGTTCAG
AAGGTTAAAGTTAAAAAAT -> AGGTTAAAGTTAAAAAATA
AAGGTTTACGTACTGGGCG -> AGGTTTACGTACTGGGCGG
AAGTAGACTGGAGGTCAAC -> AGTAGACTGGAGGTCAACG
AAGTATGCTCGCTACGCGG -> AGTATGCTCGCTACGCGGA
AAGTCAAGACCCCAGTTTT -> AGTCAAGACCCCAGTTTTA
AAGTCACTTAGTACCTAAT -> AGTCACTTAGTACCTAATA
AAGTCTGAACTACAGTGTC -> AGTCTGAACTACAGTGTCT
AAGTGCGATTCTTGGCCTG -> AGTGCGATTCTTGGCCTGG
AAGTGGCTCGCATTAGTAA -> AGTGGCTCGCATTAGTAAT
AAGTTAAAAAATAAGAGGC -> AGTTAAAAAATAAGAGGCC
AAGTTACCCCGTCGGAGGG -> AGTTACCCCGTCGGAGGGA
AAGTTGGTCTTTCCAGTCG -> AGTTGGTCTTTCCAGTCGA
AAGTTTTGATCCAGAGTGC -> AGTTTTGATCCAGAGTGCT
AATAAAGACCCATATGACT -> ATAAAGACCCATATGACTG
AATAACTGGTCCGGTTCCG -> ATAACTGGTCCGGTTCCGA
AATAAGAGGCCGAAGATGT -> ATAAGAGGCCGAAGATGTA
AATACACTGAAGGAGGAGA -> ATACACTGAAGGAGGAGAT
AATACATGAGCTTTACCTT -> ATACATGAGCTTTACCTTA
AATACATGATTCGTCAAGA -> ATACATGATTCGTCAAGAA
AATACATGCTTTAGGAGGG -> ATACATGCTTTAGGAGGGG
AATACATGTGTTCGCATGC -> ATACATGTGTTCGCATGCT
AATACTTGCATCCAATAAA -> ATACTTGCATCCAATAAAG
AATAGGGGCCCCATCCCTT -> ATAGGGGCCCCATCCCTTA
AATCACGGATGCCACTCGC -> ATCACGGATGCCACTCGCC
AATCAGCGAAATAACTGGT -> ATCAGCGAAATAACTGGTC
AATCCTACGACAGCGGCTT -> ATCCTACGACAGCGGCTTC
AATCGCCCTACTAAGGTTA -> ATCGCCCTACTAAGGTTAA
AATCGCCGCGTGAGAGAAA -> ATCGCCGCGTGAGAGAAAG
AATCTCCCCGCTCGAAGTT -> ATCTCCCCGCTCGAAGTTG
AATCTGTAAGAGGCCCCGC -> ATCTGTAAGAGGCCCCGCA
AATGAATGACTCGTGGGGC -> ATGAATGACTCGTGGGGCA
AATGACCCAGCATCAGGCG -> ATGACCCAGCATCAGGCGC
AATGACTCGTGGGGCATCA -> ATGACTCGTGGGGCATCAA
AATGATAAAGGAGCAAAAT -> ATGATAAAGGAGCAAAATT
AATGCACAACTACCATCGA -> ATGCACAACTACCATCGAA
AATTACTGTATTGGGATCG -> ATTACTGTATTGGGATCGC
AATTCAAATCACGGATGCC -> ATTCAAATCACGGATGCCA
AATTCACACTACACTGGAC -> ATTCACACTACACTGGACC
AATTCCGTATCGTCGTGGC -> ATTCCGTATCGTCGTGGCC
AATTCTGGTTGCTGTAGCT -> ATTCTGGTTGCTGTAGCTG
AATTGGTCTTTCCAGTCGA -> ATTGGTCTTTCCAGTCGAG
AATTTCGGGGGCGTTGGCG -> ATTTCGGGGGCGTTGGCGG
AATTTGGAAAGAAACGTTG -> ATTTGGAAAGAAACGTTGT
ACAACTACCATCGAAAACT -> CAACTACCATCGAAAACTT
ACAAGGAAAATTCTGGTTG -> CAAGGAAAATTCTGGTTGC
ACAATACACTGAAGGAGGA -> CAATACACTGAAGGAGGAG
ACAATTCACACTACACTGG -> CAATTCACACTACACTGGA
ACAATTCCGTATCGTCGTG -> CAATTCCGTATCGTCGTGG
ACACCGAGAACCTGGTTGC -> CACCGAGAACCTGGTTGCT
ACACCGATAGGAAATCGCC -> CACCGATAGGAAATCGCCC
ACACCGGTCGGGCACTCCA -> CACCGGTCGGGCACTCCAC
ACACGAATGAATGACTCGT -> CACGAATGAATGACTCGTG
ACACGGACGTAACTTCAGT -> CACGGACGTAACTTCAGTT
ACACGTTTGTACTGTGTGT -> CACGTTTGTACTGTGTGTC
ACACTACACTGGACCGATC -> CACTACACTGGACCGATCT
ACACTGAAGGAGGAGATGC -> CACTGAAGGAGGAGATGCG
ACACTGGACCACGCGGTTA -> CACTGGACCACGCGGTTAC
ACACTGGACCGATCTTTCT -> CACTGGACCGATCTTTCTT
ACACTGTCATAGGGACGTC -> CACTGTCATAGGGACGTCT
ACACTTCGATTAGCCACAT -> CACTTCGATTAGCCACATG
ACAGCCCCGAGGAGAACTG -> CAGCCCCGAGGAGAACTGG
ACAGCGGCTTCTGTTTGGT -> CAGCGGCTTCTGTTTGGTC
ACAGGACCTACCGCTAAAA -> CAGGACCTACCGCTAAAAT
ACAGTGGTTCAGGAAGTGC -> CAGTGGTTCAGGAAGTGCG
ACAGTGTCTCCTCTAAGTC -> CAGTGTCTCCTCTAAGTCA
ACATAGTATGCCGGTTAGC -> CATAGTATGCCGGTTAGCA
ACATGAGCTTTACCTTAGA -> CATGAGCTTTACCTTAGAA
ACATGATTCGTCAAGAAAA -> CATGATTCGTCAAGAAAAA
ACATGCTGTCAACGCACGC -> CATGCTGTCAACGCACGCT
ACATGCTTTAGGAGGGGAT -> CATGCTTTAGGAGGGGATC
ACATGTGTTCGCATGCTCA -> CATGTGTTCGCATGCTCAC
ACATTGGTGTACATAGTAT -> CATTGGTGTACATAGTATG
ACCAACTATCCTGATCAAT -> CCAACTATCCTGATCAATG
ACCACGCGGTTACTCAAAA -> CCACGCGGTTACTCAAAAG
ACCACTCCCCCGCCTTTAT -> CCACTCCCCCGCCTTTATT
ACCAGCGATAGCCGATCGG -> CCAGCGATAGCCGATCGGA
ACCAGTCTGCAGAGCGTCA -> CCAGTCTGCAGAGCGTCAC
ACCATCGAAAACTTTAGGG -> CCATCGAAAACTTTAGGGG
ACCCAGCATCAGGCGCGGG -> CCCAGCATCAGGCGCGGGT
ACCCAGTCCTTGTGAAGTA -> CCCAGTCCTTGTGAAGTAG
ACCCATATGACTGCTCGCC -> CCCATATGACTGCTCGCCG
ACCCCAGTTTTAAATCCTA -> CCCCAGTTTTAAATCCTAC
ACCCCGTCGGAGGGAGGGC -> CCCCGTCGGAGGGAGGGCG
ACCCGTAGCCTCCGGGTCA -> CCCGTAGCCTCCGGGTCAT
ACCGAGAAACAATACACTG -> CCGAGAAACAATACACTGA
ACCGAGAACCTGGTTGCTA -> CCGAGAACCTGGTTGCTAT
ACCGATAGGAAATCGCCCT -> CCGATAGGAAATCGCCCTA
ACCGATCTTTCTTTTTTGT -> CCGATCTTTCTTTTTTGTC
ACCGATGCATCCTAAAGTT -> CCGATGCATCCTAAAGTTT
ACCGCTAAAATGATAAAGG -> CCGCTAAAATGATAAAGGA
ACCGGGGGCATCGGAATCA -> CCGGGGGCATCGGAATCAG
ACCGGTCGGGCACTCCACT -> CCGGTCGGGCACTCCACTG
ACCGTTCAGCATGAAGCTG -> CCGTTCAGCATGAAGCTGG
ACCTAAGGACTTCGGTAGA -> CCTAAGGACTTCGGTAGAA
ACCTAATAGGGGCCCCATC -> CCTAATAGGGGCCCCATCC
ACCTACCGCTAAAATGATA -> CCTACCGCTAAAATGATAA
ACCTGAGTCCGCACGTCGG -> CCTGAGTCCGCACGTCGGG
ACCTGCACAATTCCGTATC -> CCTGCACAATTCCGTATCG
ACCTGCACTAAGGTCGGGC -> CCTGCACTAAGGTCGGGCC
ACCTGGTTGCTATGCTCAG -> CCTGGTTGCTATGCTCAGA
ACCTGTGGCGGTTGCATTA -> CCTGTGGCGGTTGCATTAA
ACCTTAGAAGAAGTGGCTC -> CCTTAGAAGAAGTGGCTCG
ACGAATGAATGACTCGTGG -> CGAATGAATGACTCGTGGG
ACGACAGCGGCTTCTGTTT -> CGACAGCGGCTTCTGTTTG
ACGACCAGCGATAGCCGAT -> CGACCAGCGATAGCCGATC
ACGATATTCAGATTCGTTC -> CGATATTCAGATTCGTTCA
ACGCACAGTGGTTCAGGAA -> CGCACAGTGGTTCAGGAAG
ACGCACGCTTTCAGACCAG -> CGCACGCTTTCAGACCAGT
ACGCAGTATCCCGGCGCTA -> CGCAGTATCCCGGCGCTAG
ACGCATAAGATCCGAGAAA -> CGCATAAGATCCGAGAAAG
ACGCATCTAGTCTACGTAT -> CGCATCTAGTCTACGTATC
ACGCGGACCGGGGGCATCG -> CGCGGACCGGGGGCATCGG
ACGCGGTTACTCAAAAGTT -> CGCGGTTACTCAAAAGTTA
ACGCTACACCGATAGGAAA -> CGCTACACCGATAGGAAAT
ACGCTCCGTTAGAACCCGT -> CGCTCCGTTAGAACCCGTA
ACGCTCTGTAGGCGCTCCG -> CGCTCTGTAGGCGCTCCGC
ACGCTTTCAGACCAGTCTG -> CGCTTTCAGACCAGTCTGC
ACGGACGTAACTTCAGTTA -> CGGACGTAACTTCAGTTAC
ACGGAGAGCGCCTTGGAGG -> CGGAGAGCGCCTTGGAGGA
ACGGATGCCACTCGCCCGA -> CGGATGCCACTCGCCCGAC
ACGGTAGTTGGTCCTCAAT -> CGGTAGTTGGTCCTCAATC
ACGGTCTTGAGCTGTGAAA -> CGGTCTTGAGCTGTGAAAA
ACGTAACTTCAGTTACTTA -> CGTAACTTCAGTTACTTAG
ACGTAAGAGCTGATCTAGG -> CGTAAGAGCTGATCTAGGA
ACGTACTGAAAAGTCTGAA -> CGTACTGAAAAGTCTGAAC
ACGTACTGGGCGGTTGTCA -> CGTACTGGGCGGTTGTCAG
ACGTATCCTATGATGGCAC -> CGTATCCTATGATGGCACA
ACGTCGGGTGTTGCCCTGT -> CGTCGGGTGTTGCCCTGTA
ACGTCTCATGTAGAGGTGG -> CGTCTCATGTAGAGGTGGC
ACGTCTTACTGGTCCCTCT -> CGTCTTACTGGTCCCTCTC
ACGTTCTAAGTATGCTCGC -> CGTTCTAAGTATGCTCGCT
ACGTTGTGTCTTCCGACTT -> CGTTGTGTCTTCCGACTTA
ACGTTTGGTCCGAGCGGTG -> CGTTTGGTCCGAGCGGTGT
ACGTTTGTACTGTGTGTCC -> CGTTTGTACTGTGTGTCCA
ACTAAGGTCGGGCCACCGT -> CTAAGGTCGGGCCACCGTT
ACTAAGGTTAAAGTTAAAA -> CTAAGGTTAAAGTTAAAAA
ACTACACTGGACCGATCTT -> CTACACTGGACCGATCTTT
ACTACAGTGTCTCCTCTAA -> CTACAGTGTCTCCTCTAAG
ACTACCATCGAAAACTTTA -> CTACCATCGAAAACTTTAG
ACTATCCTGATCAATGCAC -> CTATCCTGATCAATGCACA
ACTCAAAAGTTACCCCGTC -> CTCAAAAGTTACCCCGTCG
ACTCAGCCCACGCTACACC -> CTCAGCCCACGCTACACCG
ACTCCACTGTGCTGTGCCA -> CTCCACTGTGCTGTGCCAC
ACTCCCCCGCCTTTATTTG -> CTCCCCCGCCTTTATTTGG
ACTCCGATACCTAAGGACT -> CTCCGATACCTAAGGACTT
ACTCGCCCGACGGAGAGCG -> CTCGCCCGACGGAGAGCGC
ACTCGTGGGGCATCAACGT -> CTCGTGGGGCATCAACGTA
ACTCTGGGTATTGGAACAC -> CTCTGGGTATTGGAACACT
ACTGAAAAGTCTGAACTAC -> CTGAAAAGTCTGAACTACA
ACTGAAGGAGGAGATGCGC -> CTGAAGGAGGAGATGCGCA
ACTGATCTTGGTCTTTCCA -> CTGATCTTGGTCTTTCCAG
ACTGCTAGACATTGGTGTA -> CTGCTAGACATTGGTGTAC
ACTGCTCGCCGTGGTGTAC -> CTGCTCGCCGTGGTGTACA
ACTGGACCACGCGGTTACT -> CTGGACCACGCGGTTACTC
ACTGGACCGATCTTTCTTT -> CTGGACCGATCTTTCTTTT
ACTGGAGGTCAACGCTCCG -> CTGGAGGTCAACGCTCCGT
ACTGGGCGGTTGTCAGAAA -> CTGGGCGGTTGTCAGAAAA
ACTGGTCCCTCTCGCTAAA -> CTGGTCCCTCTCGCTAAAC
ACTGGTCCGGTTCCGACAC -> CTGGTCCGGTTCCGACACG
ACTGGTCCTGGCCACGCAG -> CTGGTCCTGGCCACGCAGT
ACTGTAAGACACGAATGAA -> CTGTAAGACACGAATGAAT
ACTGTATTGGGATCGCGAG -> CTGTATTGGGATCGCGAGG
ACTGTCATAGGGACGTCTT -> CTGTCATAGGGACGTCTTA
ACTGTGCTGTGCCACACGT -> CTGTGCTGTGCCACACGTT
ACTGTGTGTCCAATACTTG -> CTGTGTGTCCAATACTTGC
ACTTACGTTCTAAGTATGC -> CTTACGTTCTAAGTATGCT
ACTTAGCCCGAGTGGCAGG -> CTTAGCCCGAGTGGCAGGG
ACTTAGTACCTAATAGGGG -> CTTAGTACCTAATAGGGGC
ACTTCAGTTACTTAGCCCG -> CTTCAGTTACTTAGCCCGA
ACTTCGATTAGCCACATGC -> CTTCGATTAGCCACATGCT
ACTTCGGTAGAATTACTGT -> CTTCGGTAGAATTACTGTA
ACTTGCATCCAATAAAGAC -> CTTGCATCCAATAAAGACC
ACTTGTACAATTCACACTA -> CTTGTACAATTCACACTAC
ACTTTAGGGGGTCTGTACT -> CTTTAGGGGGTCTGTACTC
AGAAAAACCAACTATCCTG -> GAAAAACCAACTATCCTGA
AGAAAATCGCCGCGTGAGA -> GAAAATCGCCGCGTGAGAG
AGAAAATGACCCAGCATCA -> GAAAATGACCCAGCATCAG
AGAAACAATACACTGAAGG -> GAAACAATACACTGAAGGA
AGAAACGTTGTGTCTTCCG -> GAAACGTTGTGTCTTCCGA
AGAAAGAGGGCTACACCGA -> GAAAGAGGGCTACACCGAG
AGAAAGCAGACACTTCGAT -> GAAAGCAGACACTTCGATT
AGAAAGCAGTCCTGCACGG -> GAAAGCAGTCCTGCACGGT
AGAACCCGTAGCCTCCGGG -> GAACCCGTAGCCTCCGGGT
AGAACCTGGTTGCTATGCT -> GAACCTGGTTGCTATGCTC
AGAACTGGTCCTGGCCACG -> GAACTGGTCCTGGCCACGC
AGAAGAAGTGGCTCGCATT -> GAAGAAGTGGCTCGCATTA
AGAAGGCCACTTGTACAAT -> GAAGGCCACTTGTACAATT
AGAAGTGGCTCGCATTAGT -> GAAGTGGCTCGCATTAGTA
AGAATTACTGTATTGGGAT -> GAATTACTGTATTGGGATC
AGACACGAATGAATGACTC -> GACACGAATGAATGACTCG
AGACACTTCGATTAGCCAC -> GACACTTCGATTAGCCACA
AGACATTGGTGTACATAGT -> GACATTGGTGTACATAGTA
AGACCAGTCTGCAGAGCGT -> GACCAGTCTGCAGAGCGTC
AGACCCATATGACTGCTCG -> GACCCATATGACTGCTCGC
AGACCCCAGTTTTAAATCC -> GACCCCAGTTTTAAATCCT
AGACTGGAGGTCAACGCTC -> GACTGGAGGTCAACGCTCC
AGAGAAAATGACCCAGCAT -> GAGAAAATGACCCAGCATC
AGAGAAAGCAGTCCTGCAC -> GAGAAAGCAGTCCTGCACG
AGAGCGAAATTTGGAAAGA -> GAGCGAAATTTGGAAAGAA
AGAGCGCCTTGGAGGAAGG -> GAGCGCCTTGGAGGAAGGG
AGAGCGTCACAGCCCCGAG -> GAGCGTCACAGCCCCGAGG
AGAGCTAGGCGGGCATCAG -> GAGCTAGGCGGGCATCAGA
AGAGCTGATCTAGGACTCT -> GAGCTGATCTAGGACTCTG
AGAGGCCCCGCACGTTTGG -> GAGGCCCCGCACGTTTGGT
AGAGGCCGAAGATGTATTA -> GAGGCCGAAGATGTATTAA
AGAGGGCTACACCGAGAAC -> GAGGGCTACACCGAGAACC
AGAGGTGGCAGGTCGGAAG -> GAGGTGGCAGGTCGGAAGT
AGAGTGCTTTCGTATAAGA -> GAGTGCTTTCGTATAAGAG
AGATCCGAGAAAGCAGACA -> GATCCGAGAAAGCAGACAC
AGATGCGCACACCGGTCGG -> GATGCGCACACCGGTCGGG
AGATGTATGTCACGCATAA -> GATGTATGTCACGCATAAG
AGATGTATTAACCTGTGGC -> GATGTATTAACCTGTGGCG
AGATTCGTTCATCAGGTGG -> GATTCGTTCATCAGGTGGT
AGATTTTAATACATGAGCT -> GATTTTAATACATGAGCTT
AGATTTTAATACATGATTC -> GATTTTAATACATGATTCG
AGATTTTAATACATGCTTT -> GATTTTAATACATGCTTTA
AGATTTTAATACATGTGTT -> GATTTTAATACATGTGTTC
AGCAAAATTCAAATCACGG -> GCAAAATTCAAATCACGGA
AGCACGTACTGAAAAGTCT -> GCACGTACTGAAAAGTCTG
AGCAGACACTTCGATTAGC -> GCAGACACTTCGATTAGCC
AGCAGTCCTGCACGGTAGT -> GCAGTCCTGCACGGTAGTT
AGCATCAGGCGCGGGTTTT -> GCATCAGGCGCGGGTTTTA
AGCATCCCCATATCATCAG -> GCATCCCCATATCATCAGA
AGCATGAAGCTGGCGCCGG -> GCATGAAGCTGGCGCCGGC
AGCCACATGCTGTCAACGC -> GCCACATGCTGTCAACGCA
AGCCAGTTTAATCTGTAAG -> GCCAGTTTAATCTGTAAGA
AGCCCACGCTACACCGATA -> GCCCACGCTACACCGATAG
AGCCCCGAGGAGAACTGGT -> GCCCCGAGGAGAACTGGTC
AGCCCGAGTGGCAGGGTTA -> GCCCGAGTGGCAGGGTTAA
AGCCGATCGGAACGATATT -> GCCGATCGGAACGATATTC
AGCCTCCGGGTCATCAGGC -> GCCTCCGGGTCATCAGGCG
AGCGAAATAACTGGTCCGG -> GCGAAATAACTGGTCCGGT
AGCGAAATTTGGAAAGAAA -> GCGAAATTTGGAAAGAAAC
AGCGATAGCCGATCGGAAC -> GCGATAGCCGATCGGAACG
AGCGCCTTGGAGGAAGGGA -> GCGCCTTGGAGGAAGGGAG
AGCGCTATTCTCCAACCAC -> GCGCTATTCTCCAACCACT
AGCGGCTTCTGTTTGGTCT -> GCGGCTTCTGTTTGGTCTT
AGCGGTGTGGGGTGTAGGT -> GCGGTGTGGGGTGTAGGTC
AGCGTCACAGCCCCGAGGA -> GCGTCACAGCCCCGAGGAG
AGCTAGGCGGGCATCAGAT -> GCTAGGCGGGCATCAGATT
AGCTGATCTAGGACTCTGG -> GCTGATCTAGGACTCTGGG
AGCTGGACGACCAGCGATA -> GCTGGACGACCAGCGATAG
AGCTGGCGCCGGCTGATAT -> GCTGGCGCCGGCTGATATT
AGCTGTATATTTGCCGTTC -> GCTGTATATTTGCCGTTCG
AGCTGTGAAAAGGAGATGT -> GCTGTGAAAAGGAGATGTA
AGCTTCTATCATCAGATTT -> GCTTCTATCATCAGATTTT
AGCTTTACCTTAGAAGAAG -> GCTTTACCTTAGAAGAAGT
AGGAAAATTCTGGTTGCTG -> GGAAAATTCTGGTTGCTGT
AGGAAATCGCCCTACTAAG -> GGAAATCGCCCTACTAAGG
AGGAAGGGAGGCTACGCAC -> GGAAGGGAGGCTACGCACA
AGGAAGTGCGATTCTTGGC -> GGAAGTGCGATTCTTGGCC
AGGACCTACCGCTAAAATG -> GGACCTACCGCTAAAATGA
AGGACCTGCACAATTCCGT -> GGACCTGCACAATTCCGTA
AGGACTCTGGGTATTGGAA -> GGACTCTGGGTATTGGAAC
AGGACTTCGGTAGAATTAC -> GGACTTCGGTAGAATTACT
AGGAGAACTGGTCCTGGCC -> GGAGAACTGGTCCTGGCCA
AGGAGATGCGCACACCGGT -> GGAGATGCGCACACCGGTC
AGGAGATGTATGTCACGCA -> GGAGATGTATGTCACGCAT
AGGAGCAAAATTCAAATCA -> GGAGCAAAATTCAAATCAC
AGGAGGAGATGCGCACACC -> GGAGGAGATGCGCACACCG
AGGAGGGGATCCGACCTGC -> GGAGGGGATCCGACCTGCA
AGGATTAGAAAGAGGGCTA -> GGATTAGAAAGAGGGCTAC
AGGCAGCTTCTATCATCAG -> GGCAGCTTCTATCATCAGA
AGGCCACTTGTACAATTCA -> GGCCACTTGTACAATTCAC
AGGCCCCGCACGTTTGGTC -> GGCCCCGCACGTTTGGTCC
AGGCCGAAGATGTATTAAC -> GGCCGAAGATGTATTAACC
AGGCGCGGGTTTTACTGTA -> GGCGCGGGTTTTACTGTAA
AGGCGCTCCGCCGGGAAGG -> GGCGCTCCGCCGGGAAGGT
AGGCGCTTGTCTTTTGTCA -> GGCGCTTGTCTTTTGTCAA
AGGCGGGCATCAGATTTTA -> GGCGGGCATCAGATTTTAA
AGGCTACGCACAGTGGTTC -> GGCTACGCACAGTGGTTCA
AGGGACGTCTTACTGGTCC -> GGGACGTCTTACTGGTCCC
AGGGAGGCTACGCACAGTG -> GGGAGGCTACGCACAGTGG
AGGGAGGGCGCGAAGCCAG -> GGGAGGGCGCGAAGCCAGT
AGGGCAATTGGTCTTTCCA -> GGGCAATTGGTCTTTCCAG
AGGGCGCGAAGCCAGTTTA -> GGGCGCGAAGCCAGTTTAA
AGGGCTACACCGAGAACCT -> GGGCTACACCGAGAACCTG
AGGGGATCCGACCTGCACT -> GGGGATCCGACCTGCACTA
AGGGGCCCCATCCCTTACT -> GGGGCCCCATCCCTTACTG
AGGGGGTCTGTACTCAGCC -> GGGGGTCTGTACTCAGCCC
AGGGTTAAGGGCAATTGGT -> GGGTTAAGGGCAATTGGTC
AGGTCAACGCTCCGTTAGA -> GGTCAACGCTCCGTTAGAA
AGGTCCTTCAACGCATCTA -> GGTCCTTCAACGCATCTAG
AGGTCGGAAGTCAAGACCC -> GGTCGGAAGTCAAGACCCC
AGGTCGGGCCACCGTTCAG -> GGTCGGGCCACCGTTCAGC
AGGTGGCAGGTCGGAAGTC -> GGTGGCAGGTCGGAAGTCA
AGGTGGTCGATCCACGTCT -> GGTGGTCGATCCACGTCTC
AGGTTAAAGTTAAAAAATA -> GGTTAAAGTTAAAAAATAA
AGGTTTACGTACTGGGCGG -> GGTTTACGTACTGGGCGGT
AGTAATTTCGGGGGCGTTG -> GTAATTTCGGGGGCGTTGG
AGTACCTAATAGGGGCCCC -> GTACCTAATAGGGGCCCCA
AGTAGACTGGAGGTCAACG -> GTAGACTGGAGGTCAACGC
AGTATCCCGGCGCTAGCGC -> GTATCCCGGCGCTAGCGCT
AGTATGCCGGTTAGCACGT -> GTATGCCGGTTAGCACGTA
AGTATGCTCGCTACGCGGA -> GTATGCTCGCTACGCGGAC
AGTCAAGACCCCAGTTTTA -> GTCAAGACCCCAGTTTTAA
AGTCACTTAGTACCTAATA -> GTCACTTAGTACCTAATAG
AGTCCGCACGTCGGGTGTT -> GTCCGCACGTCGGGTGTTG
AGTCCTGCACGGTAGTTGG -> GTCCTGCACGGTAGTTGGT
AGTCCTTGTGAAGTAGACT -> GTCCTTGTGAAGTAGACTG
AGTCGAGAGCTAGGCGGGC -> GTCGAGAGCTAGGCGGGCA
AGTCGAGCATCCCCATATC -> GTCGAGCATCCCCATATCA
AGTCGAGGCAGCTTCTATC -> GTCGAGGCAGCTTCTATCA
AGTCGAGTTCCATCCGTGC -> GTCGAGTTCCATCCGTGCA
AGTCTACGTATCCTATGAT -> GTCTACGTATCCTATGATG
AGTCTGAACTACAGTGTCT -> GTCTGAACTACAGTGTCTC
AGTCTGCAGAGCGTCACAG -> GTCTGCAGAGCGTCACAGC
AGTGCGATTCTTGGCCTGG -> GTGCGATTCTTGGCCTGGC
AGTGCTTTCGTATAAGAGC -> GTGCTTTCGTATAAGAGCG
AGTGGCAGGGTTAAGGGCA -> GTGGCAGGGTTAAGGGCAA
AGTGGCTCGCATTAGTAAT -> GTGGCTCGCATTAGTAATT
AGTGGTTCAGGAAGTGCGA -> GTGGTTCAGGAAGTGCGAT
AGTGTCTCCTCTAAGTCAC -> GTGTCTCCTCTAAGTCACT
AGTTAAAAAATAAGAGGCC -> GTTAAAAAATAAGAGGCCG
AGTTACCCCGTCGGAGGGA -> GTTACCCCGTCGGAGGGAG
AGTTACTTAGCCCGAGTGG -> GTTACTTAGCCCGAGTGGC
AGTTCACACTGGACCACGC -> GTTCACACTGGACCACGCG
AGTTCCATCCGTGCATCAG -> GTTCCATCCGTGCATCAGA
AGTTGGTCCTCAATCTCCC -> GTTGGTCCTCAATCTCCCC
AGTTGGTCTTTCCAGTCGA -> GTTGGTCTTTCCAGTCGAG
AGTTTAATCTGTAAGAGGC -> GTTTAATCTGTAAGAGGCC
AGTTTTAAATCCTACGACA -> GTTTTAAATCCTACGACAG
AGTTTTGATCCAGAGTGCT -> GTTTTGATCCAGAGTGCTT
ATAAAGACCCATATGACTG -> TAAAGACCCATATGACTGC
ATAAAGGAGCAAAATTCAA -> TAAAGGAGCAAAATTCAAA
ATAACTGGTCCGGTTCCGA -> TAACTGGTCCGGTTCCGAC
ATAAGAGCGAAATTTGGAA -> TAAGAGCGAAATTTGGAAA
ATAAGAGGCCGAAGATGTA -> TAAGAGGCCGAAGATGTAT
ATAAGATCCGAGAAAGCAG -> TAAGATCCGAGAAAGCAGA
ATACACTGAAGGAGGAGAT -> TACACTGAAGGAGGAGATG
ATACATGAGCTTTACCTTA -> TACATGAGCTTTACCTTAG
ATACATGATTCGTCAAGAA -> TACATGATTCGTCAAGAAA
ATACATGCTTTAGGAGGGG -> TACATGCTTTAGGAGGGGA
ATACATGTGTTCGCATGCT -> TACATGTGTTCGCATGCTC
ATACCTAAGGACTTCGGTA -> TACCTAAGGACTTCGGTAG
ATACTTGCATCCAATAAAG -> TACTTGCATCCAATAAAGA
ATAGCCGATCGGAACGATA -> TAGCCGATCGGAACGATAT
ATAGGAAATCGCCCTACTA -> TAGGAAATCGCCCTACTAA
ATAGGGACGTCTTACTGGT -> TAGGGACGTCTTACTGGTC
ATAGGGGCCCCATCCCTTA -> TAGGGGCCCCATCCCTTAC
ATAGTATGCCGGTTAGCAC -> TAGTATGCCGGTTAGCACG
ATATCATCAGATTTTAATA -> TATCATCAGATTTTAATAC
ATATGACTGCTCGCCGTGG -> TATGACTGCTCGCCGTGGT
ATATTCAGATTCGTTCATC -> TATTCAGATTCGTTCATCA
ATATTCATTACCGAGAAAC -> TATTCATTACCGAGAAACA
ATATTTGCCGTTCGAAACG -> TATTTGCCGTTCGAAACGG
ATCAACGTAAGAGCTGATC -> TCAACGTAAGAGCTGATCT
ATCAATGCACAACTACCAT -> TCAATGCACAACTACCATC
ATCACGGATGCCACTCGCC -> TCACGGATGCCACTCGCCC
ATCAGATTTTAATACATGA -> TCAGATTTTAATACATGAG,TCAGATTTTAATACATGAT
ATCAGATTTTAATACATGC -> TCAGATTTTAATACATGCT
ATCAGATTTTAATACATGT -> TCAGATTTTAATACATGTG
ATCAGCGAAATAACTGGTC -> TCAGCGAAATAACTGGTCC
ATCAGGCGCGGGTTTTACT -> TCAGGCGCGGGTTTTACTG
ATCAGGCGCTTGTCTTTTG -> TCAGGCGCTTGTCTTTTGT
ATCAGGTGGTCGATCCACG -> TCAGGTGGTCGATCCACGT
ATCATCAGATTTTAATACA -> TCATCAGATTTTAATACAT,TCATCAGATTTTAATACAT
ATCCAATAAAGACCCATAT -> TCCAATAAAGACCCATATG
ATCCACGTCTCATGTAGAG -> TCCACGTCTCATGTAGAGG
ATCCAGAGTGCTTTCGTAT -> TCCAGAGTGCTTTCGTATA
ATCCCCATATCATCAGATT -> TCCCCATATCATCAGATTT
ATCCCGGCGCTAGCGCTAT -> TCCCGGCGCTAGCGCTATT
ATCCCTTACTGATCTTGGT -> TCCCTTACTGATCTTGGTC
ATCCGACCTGCACTAAGGT -> TCCGACCTGCACTAAGGTC
ATCCGAGAAAGCAGACACT -> TCCGAGAAAGCAGACACTT
ATCCGTGCATCAGATTTTA -> TCCGTGCATCAGATTTTAA
ATCCTAAAGTTTTGATCCA -> TCCTAAAGTTTTGATCCAG
ATCCTACGACAGCGGCTTC -> TCCTACGACAGCGGCTTCT
ATCCTATGATGGCACAGGA -> TCCTATGATGGCACAGGAC
ATCCTGATCAATGCACAAC -> TCCTGATCAATGCACAACT
ATCGAAAACTTTAGGGGGT -> TCGAAAACTTTAGGGGGTC
ATCGCCCTACTAAGGTTAA -> TCGCCCTACTAAGGTTAAA
ATCGCCGCGTGAGAGAAAG -> TCGCCGCGTGAGAGAAAGC
ATCGCGAGGATTAGAAAGA -> TCGCGAGGATTAGAAAGAG
ATCGGAACGATATTCAGAT -> TCGGAACGATATTCAGATT
ATCGGAATCAGCGAAATAA -> TCGGAATCAGCGAAATAAC
ATCGTCGTGGCCTCAGCTG -> TCGTCGTGGCCTCAGCTGG
ATCTAGGACTCTGGGTATT -> TCTAGGACTCTGGGTATTG
ATCTAGTCTACGTATCCTA -> TCTAGTCTACGTATCCTAT
ATCTCCCCGCTCGAAGTTG -> TCTCCCCGCTCGAAGTTGG
ATCTGTAAGAGGCCCCGCA -> TCTGTAAGAGGCCCCGCAC
ATCTTGGTCTTTCCAGTCG -> TCTTGGTCTTTCCAGTCGA
ATCTTTCTTTTTTGTCACC -> TCTTTCTTTTTTGTCACCT
ATGAAGCTGGCGCCGGCTG -> TGAAGCTGGCGCCGGCTGA
ATGAATGACTCGTGGGGCA -> TGAATGACTCGTGGGGCAT
ATGACCCAGCATCAGGCGC -> TGACCCAGCATCAGGCGCG
ATGACTCGTGGGGCATCAA -> TGACTCGTGGGGCATCAAC
ATGACTGCTCGCCGTGGTG -> TGACTGCTCGCCGTGGTGT
ATGAGCTTTACCTTAGAAG -> TGAGCTTTACCTTAGAAGA
ATGATAAAGGAGCAAAATT -> TGATAAAGGAGCAAAATTC
ATGATGGCACAGGACCTAC -> TGATGGCACAGGACCTACC
ATGATTCGTCAAGAAAAAC -> TGATTCGTCAAGAAAAACC
ATGCACAACTACCATCGAA -> TGCACAACTACCATCGAAA
ATGCATCCTAAAGTTTTGA -> TGCATCCTAAAGTTTTGAT
ATGCCACTCGCCCGACGGA -> TGCCACTCGCCCGACGGAG
ATGCCGGTTAGCACGTACT -> TGCCGGTTAGCACGTACTG
ATGCGCACACCGGTCGGGC -> TGCGCACACCGGTCGGGCA
ATGCTCACCGATGCATCCT -> TGCTCACCGATGCATCCTA
ATGCTCAGAGAAAATGACC -> TGCTCAGAGAAAATGACCC
ATGCTCGCTACGCGGACCG -> TGCTCGCTACGCGGACCGG
ATGCTGTCAACGCACGCTT -> TGCTGTCAACGCACGCTTT
ATGCTTTAGGAGGGGATCC -> TGCTTTAGGAGGGGATCCG
ATGGCACAGGACCTACCGC -> TGGCACAGGACCTACCGCT
ATGTAGAGGTGGCAGGTCG -> TGTAGAGGTGGCAGGTCGG
ATGTATGTCACGCATAAGA -> TGTATGTCACGCATAAGAT
ATGTATTAACCTGTGGCGG -> TGTATTAACCTGTGGCGGT
ATGTCACGCATAAGATCCG -> TGTCACGCATAAGATCCGA
ATGTGTTCGCATGCTCACC -> TGTGTTCGCATGCTCACCG
ATTAACCTGTGGCGGTTGC -> TTAACCTGTGGCGGTTGCA
ATTAAGAAGGCCACTTGTA -> TTAAGAAGGCCACTTGTAC
ATTACCGAGAAACAATACA -> TTACCGAGAAACAATACAC
ATTACTGTATTGGGATCGC -> TTACTGTATTGGGATCGCG
ATTAGAAAGAGGGCTACAC -> TTAGAAAGAGGGCTACACC
ATTAGCCACATGCTGTCAA -> TTAGCCACATGCTGTCAAC
ATTAGTAATTTCGGGGGCG -> TTAGTAATTTCGGGGGCGT
ATTCAAATCACGGATGCCA -> TTCAAATCACGGATGCCAC
ATTCACACTACACTGGACC -> TTCACACTACACTGGACCG
ATTCAGATTCGTTCATCAG -> TTCAGATTCGTTCATCAGG
ATTCATTACCGAGAAACAA -> TTCATTACCGAGAAACAAT
ATTCCGTATCGTCGTGGCC -> TTCCGTATCGTCGTGGCCT
ATTCGTCAAGAAAAACCAA -> TTCGTCAAGAAAAACCAAC
ATTCGTTCATCAGGTGGTC -> TTCGTTCATCAGGTGGTCG
ATTCTCCAACCACTCCCCC -> TTCTCCAACCACTCCCCCG
ATTCTGGTTGCTGTAGCTG -> TTCTGGTTGCTGTAGCTGT
ATTCTTGGCCTGGCCTTAG -> TTCTTGGCCTGGCCTTAGG
ATTGGAACACTGTCATAGG -> TTGGAACACTGTCATAGGG
ATTGGCGGCCTGGACTCCG -> TTGGCGGCCTGGACTCCGA
ATTGGGATCGCGAGGATTA -> TTGGGATCGCGAGGATTAG
ATTGGTCTTTCCAGTCGAG -> TTGGTCTTTCCAGTCGAGA
ATTGGTGTACATAGTATGC -> TTGGTGTACATAGTATGCC
ATTTCGGGGGCGTTGGCGG -> TTTCGGGGGCGTTGGCGGT
ATTTGCCGTTCGAAACGGT -> TTTGCCGTTCGAAACGGTC
ATTTGGAAAGAAACGTTGT -> TTTGGAAAGAAACGTTGTG
ATTTGGGCGTCCGCACCCA -> TTTGGGCGTCCGCACCCAG
ATTTTAATACATGAGCTTT -> TTTTAATACATGAGCTTTA
ATTTTAATACATGATTCGT -> TTTTAATACATGATTCGTC
ATTTTAATACATGCTTTAG -> TTTTAATACATGCTTTAGG
ATTTTAATACATGTGTTCG -> TTTTAATACATGTGTTCGC
CAAAAGTTACCCCGTCGGA -> AAAAGTTACCCCGTCGGAG
CAAAATTCAAATCACGGAT -> AAAATTCAAATCACGGATG
CAAATCACGGATGCCACTC -> AAATCACGGATGCCACTCG
CAACCACTCCCCCGCCTTT -> AACCACTCCCCCGCCTTTA
CAACGCACGCTTTCAGACC -> AACGCACGCTTTCAGACCA
CAACGCATCTAGTCTACGT -> AACGCATCTAGTCTACGTA
CAACGCTCCGTTAGAACCC -> AACGCTCCGTTAGAACCCG
CAACGCTCTGTAGGCGCTC -> AACGCTCTGTAGGCGCTCC
CAACGTAAGAGCTGATCTA -> AACGTAAGAGCTGATCTAG
CAACTACCATCGAAAACTT -> AACTACCATCGAAAACTTT
CAACTATCCTGATCAATGC -> AACTATCCTGATCAATGCA
CAAGAAAAACCAACTATCC -> AAGAAAAACCAACTATCCT
CAAGACCCCAGTTTTAAAT -> AAGACCCCAGTTTTAAATC
CAAGGAAAATTCTGGTTGC -> AAGGAAAATTCTGGTTGCT
CAATAAAGACCCATATGAC -> AATAAAGACCCATATGACT
CAATACACTGAAGGAGGAG -> AATACACTGAAGGAGGAGA
CAATACTTGCATCCAATAA -> AATACTTGCATCCAATAAA
CAATCTCCCCGCTCGAAGT -> AATCTCCCCGCTCGAAGTT
CAATGCACAACTACCATCG -> AATGCACAACTACCATCGA
CAATTCACACTACACTGGA -> AATTCACACTACACTGGAC
CAATTCCGTATCGTCGTGG -> AATTCCGTATCGTCGTGGC
CAATTGGTCTTTCCAGTCG -> AATTGGTCTTTCCAGTCGA
CACAACTACCATCGAAAAC -> ACAACTACCATCGAAAACT
CACAATTCCGTATCGTCGT -> ACAATTCCGTATCGTCGTG
CACACCGGTCGGGCACTCC -> ACACCGGTCGGGCACTCCA
CACACGTTTGTACTGTGTG -> ACACGTTTGTACTGTGTGT
CACACTACACTGGACCGAT -> ACACTACACTGGACCGATC
CACACTGGACCACGCGGTT -> ACACTGGACCACGCGGTTA
CACAGCCCCGAGGAGAACT -> ACAGCCCCGAGGAGAACTG
CACAGGACCTACCGCTAAA -> ACAGGACCTACCGCTAAAA
CACAGTGGTTCAGGAAGTG -> ACAGTGGTTCAGGAAGTGC
CACATGCTGTCAACGCACG -> ACATGCTGTCAACGCACGC
CACCCAGTCCTTGTGAAGT -> ACCCAGTCCTTGTGAAGTA
CACCGAGAACCTGGTTGCT -> ACCGAGAACCTGGTTGCTA
CACCGATAGGAAATCGCCC -> ACCGATAGGAAATCGCCCT
CACCGATGCATCCTAAAGT -> ACCGATGCATCCTAAAGTT
CACCGGTCGGGCACTCCAC -> ACCGGTCGGGCACTCCACT
CACCGTTCAGCATGAAGCT -> ACCGTTCAGCATGAAGCTG
CACCTGAGTCCGCACGTCG -> ACCTGAGTCCGCACGTCGG
CACGAATGAATGACTCGTG -> ACGAATGAATGACTCGTGG
CACGCAGTATCCCGGCGCT -> ACGCAGTATCCCGGCGCTA
CACGCATAAGATCCGAGAA -> ACGCATAAGATCCGAGAAA
CACGCGGTTACTCAAAAGT -> ACGCGGTTACTCAAAAGTT
CACGCTACACCGATAGGAA -> ACGCTACACCGATAGGAAA
CACGCTTTCAGACCAGTCT -> ACGCTTTCAGACCAGTCTG
CACGGACGTAACTTCAGTT -> ACGGACGTAACTTCAGTTA
CACGGATGCCACTCGCCCG -> ACGGATGCCACTCGCCCGA
CACGGTAGTTGGTCCTCAA -> ACGGTAGTTGGTCCTCAAT
CACGTACTGAAAAGTCTGA -> ACGTACTGAAAAGTCTGAA
CACGTCGGGTGTTGCCCTG -> ACGTCGGGTGTTGCCCTGT
CACGTCTCATGTAGAGGTG -> ACGTCTCATGTAGAGGTGG
CACGTTTGGTCCGAGCGGT -> ACGTTTGGTCCGAGCGGTG
CACGTTTGTACTGTGTGTC -> ACGTTTGTACTGTGTGTCC
CACTAAGGTCGGGCCACCG -> ACTAAGGTCGGGCCACCGT
CACTACACTGGACCGATCT -> ACTACACTGGACCGATCTT
CACTCCACTGTGCTGTGCC -> ACTCCACTGTGCTGTGCCA
CACTCCCCCGCCTTTATTT -> ACTCCCCCGCCTTTATTTG
CACTCGCCCGACGGAGAGC -> ACTCGCCCGACGGAGAGCG
CACTGAAGGAGGAGATGCG -> ACTGAAGGAGGAGATGCGC
CACTGGACCACGCGGTTAC -> ACTGGACCACGCGGTTACT
CACTGGACCGATCTTTCTT -> ACTGGACCGATCTTTCTTT
CACTGTCATAGGGACGTCT -> ACTGTCATAGGGACGTCTT
CACTGTGCTGTGCCACACG -> ACTGTGCTGTGCCACACGT
CACTTAGTACCTAATAGGG -> ACTTAGTACCTAATAGGGG
CACTTCGATTAGCCACATG -> ACTTCGATTAGCCACATGC
CACTTGTACAATTCACACT -> ACTTGTACAATTCACACTA
CAGAAAATCGCCGCGTGAG -> AGAAAATCGCCGCGTGAGA
CAGACACTTCGATTAGCCA -> AGACACTTCGATTAGCCAC
CAGACCAGTCTGCAGAGCG -> AGACCAGTCTGCAGAGCGT
CAGAGAAAATGACCCAGCA -> AGAGAAAATGACCCAGCAT
CAGAGCGTCACAGCCCCGA -> AGAGCGTCACAGCCCCGAG
CAGAGTGCTTTCGTATAAG -> AGAGTGCTTTCGTATAAGA
CAGATTCGTTCATCAGGTG -> AGATTCGTTCATCAGGTGG
CAGATTTTAATACATGAGC -> AGATTTTAATACATGAGCT
CAGATTTTAATACATGATT -> AGATTTTAATACATGATTC
CAGATTTTAATACATGCTT -> AGATTTTAATACATGCTTT
CAGATTTTAATACATGTGT -> AGATTTTAATACATGTGTT
CAGCATCAGGCGCGGGTTT -> AGCATCAGGCGCGGGTTTT
CAGCATGAAGCTGGCGCCG -> AGCATGAAGCTGGCGCCGG
CAGCCCACGCTACACCGAT -> AGCCCACGCTACACCGATA
CAGCCCCGAGGAGAACTGG -> AGCCCCGAGGAGAACTGGT
CAGCGAAATAACTGGTCCG -> AGCGAAATAACTGGTCCGG
CAGCGATAGCCGATCGGAA -> AGCGATAGCCGATCGGAAC
CAGCGGCTTCTGTTTGGTC -> AGCGGCTTCTGTTTGGTCT
CAGCTGGACGACCAGCGAT -> AGCTGGACGACCAGCGATA
CAGCTTCTATCATCAGATT -> AGCTTCTATCATCAGATTT
CAGGAAGTGCGATTCTTGG -> AGGAAGTGCGATTCTTGGC
CAGGACCTACCGCTAAAAT -> AGGACCTACCGCTAAAATG
CAGGCGCGGGTTTTACTGT -> AGGCGCGGGTTTTACTGTA
CAGGCGCTTGTCTTTTGTC -> AGGCGCTTGTCTTTTGTCA
CAGGGTTAAGGGCAATTGG -> AGGGTTAAGGGCAATTGGT
CAGGTCGGAAGTCAAGACC -> AGGTCGGAAGTCAAGACCC
CAGGTGGTCGATCCACGTC -> AGGTGGTCGATCCACGTCT
CAGTATCCCGGCGCTAGCG -> AGTATCCCGGCGCTAGCGC
CAGTCCTGCACGGTAGTTG -> AGTCCTGCACGGTAGTTGG
CAGTCCTTGTGAAGTAGAC -> AGTCCTTGTGAAGTAGACT
CAGTCGAGAGCTAGGCGGG -> AGTCGAGAGCTAGGCGGGC
CAGTCGAGCATCCCCATAT -> AGTCGAGCATCCCCATATC
CAGTCGAGGCAGCTTCTAT -> AGTCGAGGCAGCTTCTATC
CAGTCGAGTTCCATCCGTG -> AGTCGAGTTCCATCCGTGC
CAGTCTGCAGAGCGTCACA -> AGTCTGCAGAGCGTCACAG
CAGTGGTTCAGGAAGTGCG -> AGTGGTTCAGGAAGTGCGA
CAGTGTCTCCTCTAAGTCA -> AGTGTCTCCTCTAAGTCAC
CAGTTACTTAGCCCGAGTG -> AGTTACTTAGCCCGAGTGG
CAGTTTAATCTGTAAGAGG -> AGTTTAATCTGTAAGAGGC
CAGTTTTAAATCCTACGAC -> AGTTTTAAATCCTACGACA
CATAAGATCCGAGAAAGCA -> ATAAGATCCGAGAAAGCAG
CATAGGGACGTCTTACTGG -> ATAGGGACGTCTTACTGGT
CATAGTATGCCGGTTAGCA -> ATAGTATGCCGGTTAGCAC
CATATCATCAGATTTTAAT -> ATATCATCAGATTTTAATA
CATATGACTGCTCGCCGTG -> ATATGACTGCTCGCCGTGG
CATCAACGTAAGAGCTGAT -> ATCAACGTAAGAGCTGATC
CATCAGATTTTAATACATG -> ATCAGATTTTAATACATGA,ATCAGATTTTAATACATGA,ATCAGATTTTAATACATGC,ATCAGATTTTAATACATGT
CATCAGGCGCGGGTTTTAC -> ATCAGGCGCGGGTTTTACT
CATCAGGCGCTTGTCTTTT -> ATCAGGCGCTTGTCTTTTG
CATCAGGTGGTCGATCCAC -> ATCAGGTGGTCGATCCACG
CATCCAATAAAGACCCATA -> ATCCAATAAAGACCCATAT
CATCCCCATATCATCAGAT -> ATCCCCATATCATCAGATT
CATCCCTTACTGATCTTGG -> ATCCCTTACTGATCTTGGT
CATCCGTGCATCAGATTTT -> ATCCGTGCATCAGATTTTA
CATCCTAAAGTTTTGATCC -> ATCCTAAAGTTTTGATCCA
CATCGAAAACTTTAGGGGG -> ATCGAAAACTTTAGGGGGT
CATCGGAATCAGCGAAATA -> ATCGGAATCAGCGAAATAA
CATCTAGTCTACGTATCCT -> ATCTAGTCTACGTATCCTA
CATGAAGCTGGCGCCGGCT -> ATGAAGCTGGCGCCGGCTG
CATGAGCTTTACCTTAGAA -> ATGAGCTTTACCTTAGAAG
CATGATTCGTCAAGAAAAA -> ATGATTCGTCAAGAAAAAC
CATGCTCACCGATGCATCC -> ATGCTCACCGATGCATCCT
CATGCTGTCAACGCACGCT -> ATGCTGTCAACGCACGCTT
CATGCTTTAGGAGGGGATC -> ATGCTTTAGGAGGGGATCC
CATGTAGAGGTGGCAGGTC -> ATGTAGAGGTGGCAGGTCG
CATGTGTTCGCATGCTCAC -> ATGTGTTCGCATGCTCACC
CATTAAGAAGGCCACTTGT -> ATTAAGAAGGCCACTTGTA
CATTACCGAGAAACAATAC -> ATTACCGAGAAACAATACA
CATTAGTAATTTCGGGGGC -> ATTAGTAATTTCGGGGGCG
CATTGGTGTACATAGTATG -> ATTGGTGTACATAGTATGC
CCAACCACTCCCCCGCCTT -> CAACCACTCCCCCGCCTTT
CCAACTATCCTGATCAATG -> CAACTATCCTGATCAATGC
CCAATAAAGACCCATATGA -> CAATAAAGACCCATATGAC
CCAATACTTGCATCCAATA -> CAATACTTGCATCCAATAA
CCACACGTTTGTACTGTGT -> CACACGTTTGTACTGTGTG
CCACATGCTGTCAACGCAC -> CACATGCTGTCAACGCACG
CCACCGTTCAGCATGAAGC -> CACCGTTCAGCATGAAGCT
CCACGCAGTATCCCGGCGC -> CACGCAGTATCCCGGCGCT
CCACGCGGTTACTCAAAAG -> CACGCGGTTACTCAAAAGT
CCACGCTACACCGATAGGA -> CACGCTACACCGATAGGAA
CCACGTCTCATGTAGAGGT -> CACGTCTCATGTAGAGGTG
CCACTCCCCCGCCTTTATT -> CACTCCCCCGCCTTTATTT
CCACTCGCCCGACGGAGAG -> CACTCGCCCGACGGAGAGC
CCACTGTGCTGTGCCACAC -> CACTGTGCTGTGCCACACG
CCACTTGTACAATTCACAC -> CACTTGTACAATTCACACT
CCAGAGTGCTTTCGTATAA -> CAGAGTGCTTTCGTATAAG
CCAGCATCAGGCGCGGGTT -> CAGCATCAGGCGCGGGTTT
CCAGCGATAGCCGATCGGA -> CAGCGATAGCCGATCGGAA
CCAGTCCTTGTGAAGTAGA -> CAGTCCTTGTGAAGTAGAC
CCAGTCGAGAGCTAGGCGG -> CAGTCGAGAGCTAGGCGGG
CCAGTCGAGCATCCCCATA -> CAGTCGAGCATCCCCATAT
CCAGTCGAGGCAGCTTCTA -> CAGTCGAGGCAGCTTCTAT
CCAGTCGAGTTCCATCCGT -> CAGTCGAGTTCCATCCGTG
CCAGTCTGCAGAGCGTCAC -> CAGTCTGCAGAGCGTCACA
CCAGTTTAATCTGTAAGAG -> CAGTTTAATCTGTAAGAGG
CCAGTTTTAAATCCTACGA -> CAGTTTTAAATCCTACGAC
CCATATCATCAGATTTTAA -> CATATCATCAGATTTTAAT
CCATATGACTGCTCGCCGT -> CATATGACTGCTCGCCGTG
CCATCCCTTACTGATCTTG -> CATCCCTTACTGATCTTGG
CCATCCGTGCATCAGATTT -> CATCCGTGCATCAGATTTT
CCATCGAAAACTTTAGGGG -> CATCGAAAACTTTAGGGGG
CCCACGCTACACCGATAGG -> CCACGCTACACCGATAGGA
CCCAGCATCAGGCGCGGGT -> CCAGCATCAGGCGCGGGTT
CCCAGTCCTTGTGAAGTAG -> CCAGTCCTTGTGAAGTAGA
CCCAGTTTTAAATCCTACG -> CCAGTTTTAAATCCTACGA
CCCATATCATCAGATTTTA -> CCATATCATCAGATTTTAA
CCCATATGACTGCTCGCCG -> CCATATGACTGCTCGCCGT
CCCATCCCTTACTGATCTT -> CCATCCCTTACTGATCTTG
CCCCAGTTTTAAATCCTAC -> CCCAGTTTTAAATCCTACG
CCCCATATCATCAGATTTT -> CCCATATCATCAGATTTTA
CCCCATCCCTTACTGATCT -> CCCATCCCTTACTGATCTT
CCCCCGCCTTTATTTGGGC -> CCCCGCCTTTATTTGGGCG
CCCCGAGGAGAACTGGTCC -> CCCGAGGAGAACTGGTCCT
CCCCGCACGTTTGGTCCGA -> CCCGCACGTTTGGTCCGAG
CCCCGCCTTTATTTGGGCG -> CCCGCCTTTATTTGGGCGT
CCCCGCTCGAAGTTGGTCT -> CCCGCTCGAAGTTGGTCTT
CCCCGTCGGAGGGAGGGCG -> CCCGTCGGAGGGAGGGCGC
CCCGACGGAGAGCGCCTTG -> CCGACGGAGAGCGCCTTGG
CCCGAGGAGAACTGGTCCT -> CCGAGGAGAACTGGTCCTG
CCCGAGTGGCAGGGTTAAG -> CCGAGTGGCAGGGTTAAGG
CCCGCACGTTTGGTCCGAG -> CCGCACGTTTGGTCCGAGC
CCCGCCTTTATTTGGGCGT -> CCGCCTTTATTTGGGCGTC
CCCGCTCGAAGTTGGTCTT -> CCGCTCGAAGTTGGTCTTT
CCCGGCGCTAGCGCTATTC -> CCGGCGCTAGCGCTATTCT
CCCGTAGCCTCCGGGTCAT -> CCGTAGCCTCCGGGTCATC
CCCGTCGGAGGGAGGGCGC -> CCGTCGGAGGGAGGGCGCG
CCCTACTAAGGTTAAAGTT -> CCTACTAAGGTTAAAGTTA
CCCTCTCGCTAAACTGCTA -> CCTCTCGCTAAACTGCTAG
CCCTGTATGCGTGCCATAT -> CCTGTATGCGTGCCATATC
CCCTTACTGATCTTGGTCT -> CCTTACTGATCTTGGTCTT
CCGAAGATGTATTAACCTG -> CGAAGATGTATTAACCTGT
CCGACACGGACGTAACTTC -> CGACACGGACGTAACTTCA
CCGACCTGCACTAAGGTCG -> CGACCTGCACTAAGGTCGG
CCGACGGAGAGCGCCTTGG -> CGACGGAGAGCGCCTTGGA
CCGACTTACGTTCTAAGTA -> CGACTTACGTTCTAAGTAT
CCGAGAAACAATACACTGA -> CGAGAAACAATACACTGAA
CCGAGAAAGCAGACACTTC -> CGAGAAAGCAGACACTTCG
CCGAGAACCTGGTTGCTAT -> CGAGAACCTGGTTGCTATG
CCGAGCGGTGTGGGGTGTA -> CGAGCGGTGTGGGGTGTAG
CCGAGGAGAACTGGTCCTG -> CGAGGAGAACTGGTCCTGG
CCGAGTGGCAGGGTTAAGG -> CGAGTGGCAGGGTTAAGGG
CCGATACCTAAGGACTTCG -> CGATACCTAAGGACTTCGG
CCGATAGGAAATCGCCCTA -> CGATAGGAAATCGCCCTAC
CCGATCGGAACGATATTCA -> CGATCGGAACGATATTCAG
CCGATCTTTCTTTTTTGTC -> CGATCTTTCTTTTTTGTCA
CCGATGCATCCTAAAGTTT -> CGATGCATCCTAAAGTTTT
CCGCACCCAGTCCTTGTGA -> CGCACCCAGTCCTTGTGAA
CCGCACGTCGGGTGTTGCC -> CGCACGTCGGGTGTTGCCC
CCGCACGTTTGGTCCGAGC -> CGCACGTTTGGTCCGAGCG
CCGCCGGGAAGGTTTACGT -> CGCCGGGAAGGTTTACGTA
CCGCCTTTATTTGGGCGTC -> CGCCTTTATTTGGGCGTCC
CCGCGTGAGAGAAAGCAGT -> CGCGTGAGAGAAAGCAGTC
CCGCTAAAATGATAAAGGA -> CGCTAAAATGATAAAGGAG
CCGCTCGAAGTTGGTCTTT -> CGCTCGAAGTTGGTCTTTC
CCGGCGCTAGCGCTATTCT -> CGGCGCTAGCGCTATTCTC
CCGGCTGATATTCATTACC -> CGGCTGATATTCATTACCG
CCGGGAAGGTTTACGTACT -> CGGGAAGGTTTACGTACTG
CCGGGGGCATCGGAATCAG -> CGGGGGCATCGGAATCAGC
CCGGGTCATCAGGCGCTTG -> CGGGTCATCAGGCGCTTGT
CCGGTCGGGCACTCCACTG -> CGGTCGGGCACTCCACTGT
CCGGTTAGCACGTACTGAA -> CGGTTAGCACGTACTGAAA
CCGGTTCCGACACGGACGT -> CGGTTCCGACACGGACGTA
CCGTAGCCTCCGGGTCATC -> CGTAGCCTCCGGGTCATCA
CCGTATCGTCGTGGCCTCA -> CGTATCGTCGTGGCCTCAG
CCGTCGGAGGGAGGGCGCG -> CGTCGGAGGGAGGGCGCGA
CCGTGCATCAGATTTTAAT -> CGTGCATCAGATTTTAATA
CCGTGGTGTACAAGGAAAA -> CGTGGTGTACAAGGAAAAT
CCGTTAGAACCCGTAGCCT -> CGTTAGAACCCGTAGCCTC
CCGTTCAGCATGAAGCTGG -> CGTTCAGCATGAAGCTGGC
CCGTTCGAAACGGTCTTGA -> CGTTCGAAACGGTCTTGAG
CCTAAAGTTTTGATCCAGA -> CTAAAGTTTTGATCCAGAG
CCTAAGGACTTCGGTAGAA -> CTAAGGACTTCGGTAGAAT
CCTAATAGGGGCCCCATCC -> CTAATAGGGGCCCCATCCC
CCTACCGCTAAAATGATAA -> CTACCGCTAAAATGATAAA
CCTACGACAGCGGCTTCTG -> CTACGACAGCGGCTTCTGT
CCTACTAAGGTTAAAGTTA -> CTACTAAGGTTAAAGTTAA
CCTATGATGGCACAGGACC -> CTATGATGGCACAGGACCT
CCTCAATCTCCCCGCTCGA -> CTCAATCTCCCCGCTCGAA
CCTCAGCTGGACGACCAGC -> CTCAGCTGGACGACCAGCG
CCTCCGGGTCATCAGGCGC -> CTCCGGGTCATCAGGCGCT
CCTCTAAGTCACTTAGTAC -> CTCTAAGTCACTTAGTACC
CCTCTCGCTAAACTGCTAG -> CTCTCGCTAAACTGCTAGA
CCTGAGTCCGCACGTCGGG -> CTGAGTCCGCACGTCGGGT
CCTGATCAATGCACAACTA -> CTGATCAATGCACAACTAC
CCTGATTGGCGGCCTGGAC -> CTGATTGGCGGCCTGGACT
CCTGCACAATTCCGTATCG -> CTGCACAATTCCGTATCGT
CCTGCACGGTAGTTGGTCC -> CTGCACGGTAGTTGGTCCT
CCTGCACTAAGGTCGGGCC -> CTGCACTAAGGTCGGGCCA
CCTGGACTCCGATACCTAA -> CTGGACTCCGATACCTAAG
CCTGGCCACGCAGTATCCC -> CTGGCCACGCAGTATCCCG
CCTGGCCTTAGGACCTGCA -> CTGGCCTTAGGACCTGCAC
CCTGGTTGCTATGCTCAGA -> CTGGTTGCTATGCTCAGAG
CCTGTATGCGTGCCATATC -> CTGTATGCGTGCCATATCT
CCTGTGGCGGTTGCATTAA -> CTGTGGCGGTTGCATTAAG
CCTTACTGATCTTGGTCTT -> CTTACTGATCTTGGTCTTT
CCTTAGAAGAAGTGGCTCG -> CTTAGAAGAAGTGGCTCGC
CCTTAGGACCTGCACAATT -> CTTAGGACCTGCACAATTC
CCTTCAACGCATCTAGTCT -> CTTCAACGCATCTAGTCTA
CCTTGGAGGAAGGGAGGCT -> CTTGGAGGAAGGGAGGCTA
CCTTGTGAAGTAGACTGGA -> CTTGTGAAGTAGACTGGAG
CCTTTATTTGGGCGTCCGC -> CTTTATTTGGGCGTCCGCA
CGAAAACTTTAGGGGGTCT -> GAAAACTTTAGGGGGTCTG
CGAAACGGTCTTGAGCTGT -> GAAACGGTCTTGAGCTGTG
CGAAATAACTGGTCCGGTT -> GAAATAACTGGTCCGGTTC
CGAAATTTGGAAAGAAACG -> GAAATTTGGAAAGAAACGT
CGAAGATGTATTAACCTGT -> GAAGATGTATTAACCTGTG
CGAAGCCAGTTTAATCTGT -> GAAGCCAGTTTAATCTGTA
CGAAGTTGGTCTTTCCAGT -> GAAGTTGGTCTTTCCAGTC
CGAATGAATGACTCGTGGG -> GAATGAATGACTCGTGGGG
CGACACGGACGTAACTTCA -> GACACGGACGTAACTTCAG
CGACAGCGGCTTCTGTTTG -> GACAGCGGCTTCTGTTTGG
CGACCAGCGATAGCCGATC -> GACCAGCGATAGCCGATCG
CGACCTGCACTAAGGTCGG -> GACCTGCACTAAGGTCGGG
CGACGGAGAGCGCCTTGGA -> GACGGAGAGCGCCTTGGAG
CGACTTACGTTCTAAGTAT -> GACTTACGTTCTAAGTATG
CGAGAAACAATACACTGAA -> GAGAAACAATACACTGAAG
CGAGAAAGCAGACACTTCG -> GAGAAAGCAGACACTTCGA
CGAGAACCTGGTTGCTATG -> GAGAACCTGGTTGCTATGC
CGAGAGCTAGGCGGGCATC -> GAGAGCTAGGCGGGCATCA
CGAGCATCCCCATATCATC -> GAGCATCCCCATATCATCA
CGAGCGGTGTGGGGTGTAG -> GAGCGGTGTGGGGTGTAGG
CGAGGAGAACTGGTCCTGG -> GAGGAGAACTGGTCCTGGC
CGAGGATTAGAAAGAGGGC -> GAGGATTAGAAAGAGGGCT
CGAGGCAGCTTCTATCATC -> GAGGCAGCTTCTATCATCA
CGAGTGGCAGGGTTAAGGG -> GAGTGGCAGGGTTAAGGGC
CGAGTTCCATCCGTGCATC -> GAGTTCCATCCGTGCATCA
CGATACCTAAGGACTTCGG -> GATACCTAAGGACTTCGGT
CGATAGCCGATCGGAACGA -> GATAGCCGATCGGAACGAT
CGATAGGAAATCGCCCTAC -> GATAGGAAATCGCCCTACT
CGATATTCAGATTCGTTCA -> GATATTCAGATTCGTTCAT
CGATCCACGTCTCATGTAG -> GATCCACGTCTCATGTAGA
CGATCGGAACGATATTCAG -> GATCGGAACGATATTCAGA
CGATCTTTCTTTTTTGTCA -> GATCTTTCTTTTTTGTCAC
CGATGCATCCTAAAGTTTT -> GATGCATCCTAAAGTTTTG
CGATTAGCCACATGCTGTC -> GATTAGCCACATGCTGTCA
CGATTCTTGGCCTGGCCTT -> GATTCTTGGCCTGGCCTTA
CGCACACCGGTCGGGCACT -> GCACACCGGTCGGGCACTC
CGCACAGTGGTTCAGGAAG -> GCACAGTGGTTCAGGAAGT
CGCACCCAGTCCTTGTGAA -> GCACCCAGTCCTTGTGAAG
CGCACGCTTTCAGACCAGT -> GCACGCTTTCAGACCAGTC
CGCACGTCGGGTGTTGCCC -> GCACGTCGGGTGTTGCCCT
CGCACGTTTGGTCCGAGCG -> GCACGTTTGGTCCGAGCGG
CGCAGTATCCCGGCGCTAG -> GCAGTATCCCGGCGCTAGC
CGCATAAGATCCGAGAAAG -> GCATAAGATCCGAGAAAGC
CGCATCTAGTCTACGTATC -> GCATCTAGTCTACGTATCC
CGCATGCTCACCGATGCAT -> GCATGCTCACCGATGCATC
CGCATTAGTAATTTCGGGG -> GCATTAGTAATTTCGGGGG
CGCCCGACGGAGAGCGCCT -> GCCCGACGGAGAGCGCCTT
CGCCCTACTAAGGTTAAAG -> GCCCTACTAAGGTTAAAGT
CGCCGCGTGAGAGAAAGCA -> GCCGCGTGAGAGAAAGCAG
CGCCGGCTGATATTCATTA -> GCCGGCTGATATTCATTAC
CGCCGGGAAGGTTTACGTA -> GCCGGGAAGGTTTACGTAC
CGCCGTGGTGTACAAGGAA -> GCCGTGGTGTACAAGGAAA
CGCCTTGGAGGAAGGGAGG -> GCCTTGGAGGAAGGGAGGC
CGCCTTTATTTGGGCGTCC -> GCCTTTATTTGGGCGTCCG
CGCGAAGCCAGTTTAATCT -> GCGAAGCCAGTTTAATCTG
CGCGAGGATTAGAAAGAGG -> GCGAGGATTAGAAAGAGGG
CGCGGACCGGGGGCATCGG -> GCGGACCGGGGGCATCGGA
CGCGGGTTTTACTGTAAGA -> GCGGGTTTTACTGTAAGAC
CGCGGTTACTCAAAAGTTA -> GCGGTTACTCAAAAGTTAC
CGCGTGAGAGAAAGCAGTC -> GCGTGAGAGAAAGCAGTCC
CGCTAAAATGATAAAGGAG -> GCTAAAATGATAAAGGAGC
CGCTAAACTGCTAGACATT -> GCTAAACTGCTAGACATTG
CGCTACACCGATAGGAAAT -> GCTACACCGATAGGAAATC
CGCTACGCGGACCGGGGGC -> GCTACGCGGACCGGGGGCA
CGCTAGCGCTATTCTCCAA -> GCTAGCGCTATTCTCCAAC
CGCTATTCTCCAACCACTC -> GCTATTCTCCAACCACTCC
CGCTCCGCCGGGAAGGTTT -> GCTCCGCCGGGAAGGTTTA
CGCTCCGTTAGAACCCGTA -> GCTCCGTTAGAACCCGTAG
CGCTCGAAGTTGGTCTTTC -> GCTCGAAGTTGGTCTTTCC
CGCTCTGTAGGCGCTCCGC -> GCTCTGTAGGCGCTCCGCC
CGCTTGTCTTTTGTCAACG -> GCTTGTCTTTTGTCAACGC
CGCTTTCAGACCAGTCTGC -> GCTTTCAGACCAGTCTGCA
CGGAACGATATTCAGATTC -> GGAACGATATTCAGATTCG
CGGAAGTCAAGACCCCAGT -> GGAAGTCAAGACCCCAGTT
CGGAATCAGCGAAATAACT -> GGAATCAGCGAAATAACTG
CGGACCGGGGGCATCGGAA -> GGACCGGGGGCATCGGAAT
CGGACGTAACTTCAGTTAC -> GGACGTAACTTCAGTTACT
CGGAGAGCGCCTTGGAGGA -> GGAGAGCGCCTTGGAGGAA
CGGAGGGAGGGCGCGAAGC -> GGAGGGAGGGCGCGAAGCC
CGGATGCCACTCGCCCGAC -> GGATGCCACTCGCCCGACG
CGGCCTGGACTCCGATACC -> GGCCTGGACTCCGATACCT
CGGCGCTAGCGCTATTCTC -> GGCGCTAGCGCTATTCTCC
CGGCTGATATTCATTACCG -> GGCTGATATTCATTACCGA
CGGCTTCTGTTTGGTCTTT -> GGCTTCTGTTTGGTCTTTC
CGGGAAGGTTTACGTACTG -> GGGAAGGTTTACGTACTGG
CGGGCACTCCACTGTGCTG -> GGGCACTCCACTGTGCTGT
CGGGCATCAGATTTTAATA -> GGGCATCAGATTTTAATAC
CGGGCCACCGTTCAGCATG -> GGGCCACCGTTCAGCATGA
CGGGGGCATCGGAATCAGC -> GGGGGCATCGGAATCAGCG
CGGGGGCGTTGGCGGTCTC -> GGGGGCGTTGGCGGTCTCC
CGGGTCATCAGGCGCTTGT -> GGGTCATCAGGCGCTTGTC
CGGGTGTTGCCCTGTATGC -> GGGTGTTGCCCTGTATGCG
CGGGTTTTACTGTAAGACA -> GGGTTTTACTGTAAGACAC
CGGTAGAATTACTGTATTG -> GGTAGAATTACTGTATTGG
CGGTAGTTGGTCCTCAATC -> GGTAGTTGGTCCTCAATCT
CGGTCGGGCACTCCACTGT -> GGTCGGGCACTCCACTGTG
CGGTCTCCTGATTGGCGGC -> GGTCTCCTGATTGGCGGCC
CGGTCTTGAGCTGTGAAAA -> GGTCTTGAGCTGTGAAAAG
CGGTGTGGGGTGTAGGTCC -> GGTGTGGGGTGTAGGTCCT
CGGTTACTCAAAAGTTACC -> GGTTACTCAAAAGTTACCC
CGGTTAGCACGTACTGAAA -> GGTTAGCACGTACTGAAAA
CGGTTCCGACACGGACGTA -> GGTTCCGACACGGACGTAA
CGGTTGCATTAAGAAGGCC -> GGTTGCATTAAGAAGGCCA
CGGTTGTCAGAAAATCGCC -> GGTTGTCAGAAAATCGCCG
CGTAACTTCAGTTACTTAG -> GTAACTTCAGTTACTTAGC
CGTAAGAGCTGATCTAGGA -> GTAAGAGCTGATCTAGGAC
CGTACTGAAAAGTCTGAAC -> GTACTGAAAAGTCTGAACT
CGTACTGGGCGGTTGTCAG -> GTACTGGGCGGTTGTCAGA
CGTAGCCTCCGGGTCATCA -> GTAGCCTCCGGGTCATCAG
CGTATAAGAGCGAAATTTG -> GTATAAGAGCGAAATTTGG
CGTATCCTATGATGGCACA -> GTATCCTATGATGGCACAG
CGTATCGTCGTGGCCTCAG -> GTATCGTCGTGGCCTCAGC
CGTCAAGAAAAACCAACTA -> GTCAAGAAAAACCAACTAT
CGTCACAGCCCCGAGGAGA -> GTCACAGCCCCGAGGAGAA
CGTCCGCACCCAGTCCTTG -> GTCCGCACCCAGTCCTTGT
CGTCGGAGGGAGGGCGCGA -> GTCGGAGGGAGGGCGCGAA
CGTCGGGTGTTGCCCTGTA -> GTCGGGTGTTGCCCTGTAT
CGTCGTGGCCTCAGCTGGA -> GTCGTGGCCTCAGCTGGAC
CGTCTCATGTAGAGGTGGC -> GTCTCATGTAGAGGTGGCA
CGTCTTACTGGTCCCTCTC -> GTCTTACTGGTCCCTCTCG
CGTGAGAGAAAGCAGTCCT -> GTGAGAGAAAGCAGTCCTG
CGTGCATCAGATTTTAATA -> GTGCATCAGATTTTAATAC
CGTGGCCTCAGCTGGACGA -> GTGGCCTCAGCTGGACGAC
CGTGGGGCATCAACGTAAG -> GTGGGGCATCAACGTAAGA
CGTGGTGTACAAGGAAAAT -> GTGGTGTACAAGGAAAATT
CGTTAGAACCCGTAGCCTC -> GTTAGAACCCGTAGCCTCC
CGTTCAGCATGAAGCTGGC -> GTTCAGCATGAAGCTGGCG
CGTTCATCAGGTGGTCGAT -> GTTCATCAGGTGGTCGATC
CGTTCGAAACGGTCTTGAG -> GTTCGAAACGGTCTTGAGC
CGTTCTAAGTATGCTCGCT -> GTTCTAAGTATGCTCGCTA
CGTTGGCGGTCTCCTGATT -> GTTGGCGGTCTCCTGATTG
CGTTGTGTCTTCCGACTTA -> GTTGTGTCTTCCGACTTAC
CGTTTGGTCCGAGCGGTGT -> GTTTGGTCCGAGCGGTGTG
CGTTTGTACTGTGTGTCCA -> GTTTGTACTGTGTGTCCAA
CTAAAATGATAAAGGAGCA -> TAAAATGATAAAGGAGCAA
CTAAACTGCTAGACATTGG -> TAAACTGCTAGACATTGGT
CTAAAGTTTTGATCCAGAG -> TAAAGTTTTGATCCAGAGT
CTAAGGACTTCGGTAGAAT -> TAAGGACTTCGGTAGAATT
CTAAGGTCGGGCCACCGTT -> TAAGGTCGGGCCACCGTTC
CTAAGGTTAAAGTTAAAAA -> TAAGGTTAAAGTTAAAAAA
CTAAGTATGCTCGCTACGC -> TAAGTATGCTCGCTACGCG
CTAAGTCACTTAGTACCTA -> TAAGTCACTTAGTACCTAA
CTAATAGGGGCCCCATCCC -> TAATAGGGGCCCCATCCCT
CTACACCGAGAACCTGGTT -> TACACCGAGAACCTGGTTG
CTACACCGATAGGAAATCG -> TACACCGATAGGAAATCGC
CTACACTGGACCGATCTTT -> TACACTGGACCGATCTTTC
CTACAGTGTCTCCTCTAAG -> TACAGTGTCTCCTCTAAGT
CTACCATCGAAAACTTTAG -> TACCATCGAAAACTTTAGG
CTACCGCTAAAATGATAAA -> TACCGCTAAAATGATAAAG
CTACGACAGCGGCTTCTGT -> TACGACAGCGGCTTCTGTT
CTACGCACAGTGGTTCAGG -> TACGCACAGTGGTTCAGGA
CTACGCGGACCGGGGGCAT -> TACGCGGACCGGGGGCATC
CTACGTATCCTATGATGGC -> TACGTATCCTATGATGGCA
CTACTAAGGTTAAAGTTAA -> TACTAAGGTTAAAGTTAAA
CTAGACATTGGTGTACATA -> TAGACATTGGTGTACATAG
CTAGCGCTATTCTCCAACC -> TAGCGCTATTCTCCAACCA
CTAGGACTCTGGGTATTGG -> TAGGACTCTGGGTATTGGA
CTAGGCGGGCATCAGATTT -> TAGGCGGGCATCAGATTTT
CTAGTCTACGTATCCTATG -> TAGTCTACGTATCCTATGA
CTAGTTCACACTGGACCAC -> TAGTTCACACTGGACCACG
CTATCATCAGATTTTAATA -> TATCATCAGATTTTAATAC
CTATCCTGATCAATGCACA -> TATCCTGATCAATGCACAA
CTATGATGGCACAGGACCT -> TATGATGGCACAGGACCTA
CTATGCTCAGAGAAAATGA -> TATGCTCAGAGAAAATGAC
CTATTCTCCAACCACTCCC -> TATTCTCCAACCACTCCCC
CTCAAAAGTTACCCCGTCG -> TCAAAAGTTACCCCGTCGG
CTCAATCTCCCCGCTCGAA -> TCAATCTCCCCGCTCGAAG
CTCACCGATGCATCCTAAA -> TCACCGATGCATCCTAAAG
CTCAGAGAAAATGACCCAG -> TCAGAGAAAATGACCCAGC
CTCAGCCCACGCTACACCG -> TCAGCCCACGCTACACCGA
CTCAGCTGGACGACCAGCG -> TCAGCTGGACGACCAGCGA
CTCATGTAGAGGTGGCAGG -> TCATGTAGAGGTGGCAGGT
CTCCAACCACTCCCCCGCC -> TCCAACCACTCCCCCGCCT
CTCCACTGTGCTGTGCCAC -> TCCACTGTGCTGTGCCACA
CTCCCCCGCCTTTATTTGG -> TCCCCCGCCTTTATTTGGG
CTCCCCGCTCGAAGTTGGT -> TCCCCGCTCGAAGTTGGTC
CTCCGATACCTAAGGACTT -> TCCGATACCTAAGGACTTC
CTCCGCCGGGAAGGTTTAC -> TCCGCCGGGAAGGTTTACG
CTCCGGGTCATCAGGCGCT -> TCCGGGTCATCAGGCGCTT
CTCCGTTAGAACCCGTAGC -> TCCGTTAGAACCCGTAGCC
CTCCTCTAAGTCACTTAGT -> TCCTCTAAGTCACTTAGTA
CTCCTGATTGGCGGCCTGG -> TCCTGATTGGCGGCCTGGA
CTCGAAGTTGGTCTTTCCA -> TCGAAGTTGGTCTTTCCAG
CTCGCATTAGTAATTTCGG -> TCGCATTAGTAATTTCGGG
CTCGCCCGACGGAGAGCGC -> TCGCCCGACGGAGAGCGCC
CTCGCCGTGGTGTACAAGG -> TCGCCGTGGTGTACAAGGA
CTCGCTAAACTGCTAGACA -> TCGCTAAACTGCTAGACAT
CTCGCTACGCGGACCGGGG -> TCGCTACGCGGACCGGGGG
CTCGTGGGGCATCAACGTA -> TCGTGGGGCATCAACGTAA
CTCTAAGTCACTTAGTACC -> TCTAAGTCACTTAGTACCT
CTCTCGCTAAACTGCTAGA -> TCTCGCTAAACTGCTAGAC
CTCTGGGTATTGGAACACT -> TCTGGGTATTGGAACACTG
CTCTGTAGGCGCTCCGCCG -> TCTGTAGGCGCTCCGCCGG
CTGAAAAGTCTGAACTACA -> TGAAAAGTCTGAACTACAG
CTGAACTACAGTGTCTCCT -> TGAACTACAGTGTCTCCTC
CTGAAGGAGGAGATGCGCA -> TGAAGGAGGAGATGCGCAC
CTGAGTCCGCACGTCGGGT -> TGAGTCCGCACGTCGGGTG
CTGATATTCATTACCGAGA -> TGATATTCATTACCGAGAA
CTGATCAATGCACAACTAC -> TGATCAATGCACAACTACC
CTGATCTAGGACTCTGGGT -> TGATCTAGGACTCTGGGTA
CTGATCTTGGTCTTTCCAG -> TGATCTTGGTCTTTCCAGT
CTGATTGGCGGCCTGGACT -> TGATTGGCGGCCTGGACTC
CTGCACAATTCCGTATCGT -> TGCACAATTCCGTATCGTC
CTGCACGGTAGTTGGTCCT -> TGCACGGTAGTTGGTCCTC
CTGCACTAAGGTCGGGCCA -> TGCACTAAGGTCGGGCCAC
CTGCAGAGCGTCACAGCCC -> TGCAGAGCGTCACAGCCCC
CTGCTAGACATTGGTGTAC -> TGCTAGACATTGGTGTACA
CTGCTCGCCGTGGTGTACA -> TGCTCGCCGTGGTGTACAA
CTGGACCACGCGGTTACTC -> TGGACCACGCGGTTACTCA
CTGGACCGATCTTTCTTTT -> TGGACCGATCTTTCTTTTT
CTGGACGACCAGCGATAGC -> TGGACGACCAGCGATAGCC
CTGGACTCCGATACCTAAG -> TGGACTCCGATACCTAAGG
CTGGAGGTCAACGCTCCGT -> TGGAGGTCAACGCTCCGTT
CTGGCCACGCAGTATCCCG -> TGGCCACGCAGTATCCCGG
CTGGCCTTAGGACCTGCAC -> TGGCCTTAGGACCTGCACA
CTGGCGCCGGCTGATATTC -> TGGCGCCGGCTGATATTCA
CTGGGCGGTTGTCAGAAAA -> TGGGCGGTTGTCAGAAAAT
CTGGGTATTGGAACACTGT -> TGGGTATTGGAACACTGTC
CTGGTCCCTCTCGCTAAAC -> TGGTCCCTCTCGCTAAACT
CTGGTCCGGTTCCGACACG -> TGGTCCGGTTCCGACACGG
CTGGTCCTGGCCACGCAGT -> TGGTCCTGGCCACGCAGTA
CTGGTTGCTATGCTCAGAG -> TGGTTGCTATGCTCAGAGA
CTGGTTGCTGTAGCTGTAT -> TGGTTGCTGTAGCTGTATA
CTGTAAGACACGAATGAAT -> TGTAAGACACGAATGAATG
CTGTAAGAGGCCCCGCACG -> TGTAAGAGGCCCCGCACGT
CTGTACTCAGCCCACGCTA -> TGTACTCAGCCCACGCTAC
CTGTAGCTGTATATTTGCC -> TGTAGCTGTATATTTGCCG
CTGTAGGCGCTCCGCCGGG -> TGTAGGCGCTCCGCCGGGA
CTGTATATTTGCCGTTCGA -> TGTATATTTGCCGTTCGAA
CTGTATGCGTGCCATATCT -> TGTATGCGTGCCATATCTA
CTGTATTGGGATCGCGAGG -> TGTATTGGGATCGCGAGGA
CTGTCAACGCACGCTTTCA -> TGTCAACGCACGCTTTCAG
CTGTCATAGGGACGTCTTA -> TGTCATAGGGACGTCTTAC
CTGTGAAAAGGAGATGTAT -> TGTGAAAAGGAGATGTATG
CTGTGCCACACGTTTGTAC -> TGTGCCACACGTTTGTACT
CTGTGCTGTGCCACACGTT -> TGTGCTGTGCCACACGTTT
CTGTGGCGGTTGCATTAAG -> TGTGGCGGTTGCATTAAGA
CTGTGTGTCCAATACTTGC -> TGTGTGTCCAATACTTGCA
CTGTTTGGTCTTTCCAGTC -> TGTTTGGTCTTTCCAGTCG
CTTACGTTCTAAGTATGCT -> TTACGTTCTAAGTATGCTC
CTTACTGATCTTGGTCTTT -> TTACTGATCTTGGTCTTTC
CTTACTGGTCCCTCTCGCT -> TTACTGGTCCCTCTCGCTA
CTTAGAAGAAGTGGCTCGC -> TTAGAAGAAGTGGCTCGCA
CTTAGCCCGAGTGGCAGGG -> TTAGCCCGAGTGGCAGGGT
CTTAGGACCTGCACAATTC -> TTAGGACCTGCACAATTCC
CTTAGTACCTAATAGGGGC -> TTAGTACCTAATAGGGGCC
CTTCAACGCATCTAGTCTA -> TTCAACGCATCTAGTCTAC
CTTCAGTTACTTAGCCCGA -> TTCAGTTACTTAGCCCGAG
CTTCCGACTTACGTTCTAA -> TTCCGACTTACGTTCTAAG
CTTCGATTAGCCACATGCT -> TTCGATTAGCCACATGCTG
CTTCGGTAGAATTACTGTA -> TTCGGTAGAATTACTGTAT
CTTCTATCATCAGATTTTA -> TTCTATCATCAGATTTTAA
CTTCTGTTTGGTCTTTCCA -> TTCTGTTTGGTCTTTCCAG
CTTGAGCTGTGAAAAGGAG -> TTGAGCTGTGAAAAGGAGA
CTTGCATCCAATAAAGACC -> TTGCATCCAATAAAGACCC
CTTGGAGGAAGGGAGGCTA -> TTGGAGGAAGGGAGGCTAC
CTTGGCCTGGCCTTAGGAC -> TTGGCCTGGCCTTAGGACC
CTTGGTCTTTCCAGTCGAG -> TTGGTCTTTCCAGTCGAGC
CTTGTACAATTCACACTAC -> TTGTACAATTCACACTACA
CTTGTCTTTTGTCAACGCT -> TTGTCTTTTGTCAACGCTC
CTTGTGAAGTAGACTGGAG -> TTGTGAAGTAGACTGGAGG
CTTTACCTTAGAAGAAGTG -> TTTACCTTAGAAGAAGTGG
CTTTAGGAGGGGATCCGAC -> TTTAGGAGGGGATCCGACC
CTTTAGGGGGTCTGTACTC -> TTTAGGGGGTCTGTACTCA
CTTTATTTGGGCGTCCGCA -> TTTATTTGGGCGTCCGCAC
CTTTCAGACCAGTCTGCAG -> TTTCAGACCAGTCTGCAGA
CTTTCCAGTCGAGAGCTAG -> TTTCCAGTCGAGAGCTAGG
CTTTCCAGTCGAGCATCCC -> TTTCCAGTCGAGCATCCCC
CTTTCCAGTCGAGGCAGCT -> TTTCCAGTCGAGGCAGCTT
CTTTCCAGTCGAGTTCCAT -> TTTCCAGTCGAGTTCCATC
CTTTCGTATAAGAGCGAAA -> TTTCGTATAAGAGCGAAAT
CTTTCTTTTTTGTCACCTG -> TTTCTTTTTTGTCACCTGA
CTTTTGTCAACGCTCTGTA -> TTTTGTCAACGCTCTGTAG
CTTTTTTGTCACCTGAGTC -> TTTTTTGTCACCTGAGTCC
GAAAAACCAACTATCCTGA -> AAAAACCAACTATCCTGAT
GAAAACTTTAGGGGGTCTG -> AAAACTTTAGGGGGTCTGT
GAAAAGGAGATGTATGTCA -> AAAAGGAGATGTATGTCAC
GAAAAGTCTGAACTACAGT -> AAAAGTCTGAACTACAGTG
GAAAATCGCCGCGTGAGAG -> AAAATCGCCGCGTGAGAGA
GAAAATGACCCAGCATCAG -> AAAATGACCCAGCATCAGG
GAAAATTCTGGTTGCTGTA -> AAAATTCTGGTTGCTGTAG
GAAACAATACACTGAAGGA -> AAACAATACACTGAAGGAG
GAAACGGTCTTGAGCTGTG -> AAACGGTCTTGAGCTGTGA
GAAACGTTGTGTCTTCCGA -> AAACGTTGTGTCTTCCGAC
GAAAGAAACGTTGTGTCTT -> AAAGAAACGTTGTGTCTTC
GAAAGAGGGCTACACCGAG -> AAAGAGGGCTACACCGAGA
GAAAGCAGACACTTCGATT -> AAAGCAGACACTTCGATTA
GAAAGCAGTCCTGCACGGT -> AAAGCAGTCCTGCACGGTA
GAAATAACTGGTCCGGTTC -> AAATAACTGGTCCGGTTCC
GAAATCGCCCTACTAAGGT -> AAATCGCCCTACTAAGGTT
GAAATTTGGAAAGAAACGT -> AAATTTGGAAAGAAACGTT
GAACACTGTCATAGGGACG -> AACACTGTCATAGGGACGT
GAACCCGTAGCCTCCGGGT -> AACCCGTAGCCTCCGGGTC
GAACCTGGTTGCTATGCTC -> AACCTGGTTGCTATGCTCA
GAACGATATTCAGATTCGT -> AACGATATTCAGATTCGTT
GAACTACAGTGTCTCCTCT -> AACTACAGTGTCTCCTCTA
GAACTGGTCCTGGCCACGC -> AACTGGTCCTGGCCACGCA
GAAGAAGTGGCTCGCATTA -> AAGAAGTGGCTCGCATTAG
GAAGATGTATTAACCTGTG -> AAGATGTATTAACCTGTGG
GAAGCCAGTTTAATCTGTA -> AAGCCAGTTTAATCTGTAA
GAAGCTGGCGCCGGCTGAT -> AAGCTGGCGCCGGCTGATA
GAAGGAGGAGATGCGCACA -> AAGGAGGAGATGCGCACAC
GAAGGCCACTTGTACAATT -> AAGGCCACTTGTACAATTC
GAAGGGAGGCTACGCACAG -> AAGGGAGGCTACGCACAGT
GAAGGTTTACGTACTGGGC -> AAGGTTTACGTACTGGGCG
GAAGTAGACTGGAGGTCAA -> AAGTAGACTGGAGGTCAAC
GAAGTCAAGACCCCAGTTT -> AAGTCAAGACCCCAGTTTT
GAAGTGCGATTCTTGGCCT -> AAGTGCGATTCTTGGCCTG
GAAGTGGCTCGCATTAGTA -> AAGTGGCTCGCATTAGTAA
GAAGTTGGTCTTTCCAGTC -> AAGTTGGTCTTTCCAGTCG
GAATCAGCGAAATAACTGG -> AATCAGCGAAATAACTGGT
GAATGAATGACTCGTGGGG -> AATGAATGACTCGTGGGGC
GAATGACTCGTGGGGCATC -> AATGACTCGTGGGGCATCA
GAATTACTGTATTGGGATC -> AATTACTGTATTGGGATCG
GACACGAATGAATGACTCG -> ACACGAATGAATGACTCGT
GACACGGACGTAACTTCAG -> ACACGGACGTAACTTCAGT
GACACTTCGATTAGCCACA -> ACACTTCGATTAGCCACAT
GACAGCGGCTTCTGTTTGG -> ACAGCGGCTTCTGTTTGGT
GACATTGGTGTACATAGTA -> ACATTGGTGTACATAGTAT
GACCACGCGGTTACTCAAA -> ACCACGCGGTTACTCAAAA
GACCAGCGATAGCCGATCG -> ACCAGCGATAGCCGATCGG
GACCAGTCTGCAGAGCGTC -> ACCAGTCTGCAGAGCGTCA
GACCCAGCATCAGGCGCGG -> ACCCAGCATCAGGCGCGGG
GACCCATATGACTGCTCGC -> ACCCATATGACTGCTCGCC
GACCCCAGTTTTAAATCCT -> ACCCCAGTTTTAAATCCTA
GACCGATCTTTCTTTTTTG -> ACCGATCTTTCTTTTTTGT
GACCGGGGGCATCGGAATC -> ACCGGGGGCATCGGAATCA
GACCTACCGCTAAAATGAT -> ACCTACCGCTAAAATGATA
GACCTGCACAATTCCGTAT -> ACCTGCACAATTCCGTATC
GACCTGCACTAAGGTCGGG -> ACCTGCACTAAGGTCGGGC
GACGACCAGCGATAGCCGA -> ACGACCAGCGATAGCCGAT
GACGGAGAGCGCCTTGGAG -> ACGGAGAGCGCCTTGGAGG
GACGTAACTTCAGTTACTT -> ACGTAACTTCAGTTACTTA
GACGTCTTACTGGTCCCTC -> ACGTCTTACTGGTCCCTCT
GACTCCGATACCTAAGGAC -> ACTCCGATACCTAAGGACT
GACTCGTGGGGCATCAACG -> ACTCGTGGGGCATCAACGT
GACTCTGGGTATTGGAACA -> ACTCTGGGTATTGGAACAC
GACTGCTCGCCGTGGTGTA -> ACTGCTCGCCGTGGTGTAC
GACTGGAGGTCAACGCTCC -> ACTGGAGGTCAACGCTCCG
GACTTACGTTCTAAGTATG -> ACTTACGTTCTAAGTATGC
GACTTCGGTAGAATTACTG -> ACTTCGGTAGAATTACTGT
GAGAAAATGACCCAGCATC -> AGAAAATGACCCAGCATCA
GAGAAACAATACACTGAAG -> AGAAACAATACACTGAAGG
GAGAAAGCAGACACTTCGA -> AGAAAGCAGACACTTCGAT
GAGAAAGCAGTCCTGCACG -> AGAAAGCAGTCCTGCACGG
GAGAACCTGGTTGCTATGC -> AGAACCTGGTTGCTATGCT
GAGAACTGGTCCTGGCCAC -> AGAACTGGTCCTGGCCACG
GAGAGAAAGCAGTCCTGCA -> AGAGAAAGCAGTCCTGCAC
GAGAGCGCCTTGGAGGAAG -> AGAGCGCCTTGGAGGAAGG
GAGAGCTAGGCGGGCATCA -> AGAGCTAGGCGGGCATCAG
GAGATGCGCACACCGGTCG -> AGATGCGCACACCGGTCGG
GAGATGTATGTCACGCATA -> AGATGTATGTCACGCATAA
GAGCAAAATTCAAATCACG -> AGCAAAATTCAAATCACGG
GAGCATCCCCATATCATCA -> AGCATCCCCATATCATCAG
GAGCGAAATTTGGAAAGAA -> AGCGAAATTTGGAAAGAAA
GAGCGCCTTGGAGGAAGGG -> AGCGCCTTGGAGGAAGGGA
GAGCGGTGTGGGGTGTAGG -> AGCGGTGTGGGGTGTAGGT
GAGCGTCACAGCCCCGAGG -> AGCGTCACAGCCCCGAGGA
GAGCTAGGCGGGCATCAGA -> AGCTAGGCGGGCATCAGAT
GAGCTGATCTAGGACTCTG -> AGCTGATCTAGGACTCTGG
GAGCTGTGAAAAGGAGATG -> AGCTGTGAAAAGGAGATGT
GAGCTTTACCTTAGAAGAA -> AGCTTTACCTTAGAAGAAG
GAGGAAGGGAGGCTACGCA -> AGGAAGGGAGGCTACGCAC
GAGGAGAACTGGTCCTGGC -> AGGAGAACTGGTCCTGGCC
GAGGAGATGCGCACACCGG -> AGGAGATGCGCACACCGGT
GAGGATTAGAAAGAGGGCT -> AGGATTAGAAAGAGGGCTA
GAGGCAGCTTCTATCATCA -> AGGCAGCTTCTATCATCAG
GAGGCCCCGCACGTTTGGT -> AGGCCCCGCACGTTTGGTC
GAGGCCGAAGATGTATTAA -> AGGCCGAAGATGTATTAAC
GAGGCTACGCACAGTGGTT -> AGGCTACGCACAGTGGTTC
GAGGGAGGGCGCGAAGCCA -> AGGGAGGGCGCGAAGCCAG
GAGGGCGCGAAGCCAGTTT -> AGGGCGCGAAGCCAGTTTA
GAGGGCTACACCGAGAACC -> AGGGCTACACCGAGAACCT
GAGGGGATCCGACCTGCAC -> AGGGGATCCGACCTGCACT
GAGGTCAACGCTCCGTTAG -> AGGTCAACGCTCCGTTAGA
GAGGTGGCAGGTCGGAAGT -> AGGTGGCAGGTCGGAAGTC
GAGTCCGCACGTCGGGTGT -> AGTCCGCACGTCGGGTGTT
GAGTGCTTTCGTATAAGAG -> AGTGCTTTCGTATAAGAGC
GAGTGGCAGGGTTAAGGGC -> AGTGGCAGGGTTAAGGGCA
GAGTTCCATCCGTGCATCA -> AGTTCCATCCGTGCATCAG
GATAAAGGAGCAAAATTCA -> ATAAAGGAGCAAAATTCAA
GATACCTAAGGACTTCGGT -> ATACCTAAGGACTTCGGTA
GATAGCCGATCGGAACGAT -> ATAGCCGATCGGAACGATA
GATAGGAAATCGCCCTACT -> ATAGGAAATCGCCCTACTA
GATATTCAGATTCGTTCAT -> ATATTCAGATTCGTTCATC
GATATTCATTACCGAGAAA -> ATATTCATTACCGAGAAAC
GATCAATGCACAACTACCA -> ATCAATGCACAACTACCAT
GATCCACGTCTCATGTAGA -> ATCCACGTCTCATGTAGAG
GATCCAGAGTGCTTTCGTA -> ATCCAGAGTGCTTTCGTAT
GATCCGACCTGCACTAAGG -> ATCCGACCTGCACTAAGGT
GATCCGAGAAAGCAGACAC -> ATCCGAGAAAGCAGACACT
GATCGCGAGGATTAGAAAG -> ATCGCGAGGATTAGAAAGA
GATCGGAACGATATTCAGA -> ATCGGAACGATATTCAGAT
GATCTAGGACTCTGGGTAT -> ATCTAGGACTCTGGGTATT
GATCTTGGTCTTTCCAGTC -> ATCTTGGTCTTTCCAGTCG
GATCTTTCTTTTTTGTCAC -> ATCTTTCTTTTTTGTCACC
GATGCATCCTAAAGTTTTG -> ATGCATCCTAAAGTTTTGA
GATGCCACTCGCCCGACGG -> ATGCCACTCGCCCGACGGA
GATGCGCACACCGGTCGGG -> ATGCGCACACCGGTCGGGC
GATGGCACAGGACCTACCG -> ATGGCACAGGACCTACCGC
GATGTATGTCACGCATAAG -> ATGTATGTCACGCATAAGA
GATGTATTAACCTGTGGCG -> ATGTATTAACCTGTGGCGG
GATTAGAAAGAGGGCTACA -> ATTAGAAAGAGGGCTACAC
GATTAGCCACATGCTGTCA -> ATTAGCCACATGCTGTCAA
GATTCGTCAAGAAAAACCA -> ATTCGTCAAGAAAAACCAA
GATTCGTTCATCAGGTGGT -> ATTCGTTCATCAGGTGGTC
GATTCTTGGCCTGGCCTTA -> ATTCTTGGCCTGGCCTTAG
GATTGGCGGCCTGGACTCC -> ATTGGCGGCCTGGACTCCG
GATTTTAATACATGAGCTT -> ATTTTAATACATGAGCTTT
GATTTTAATACATGATTCG -> ATTTTAATACATGATTCGT
GATTTTAATACATGCTTTA -> ATTTTAATACATGCTTTAG
GATTTTAATACATGTGTTC -> ATTTTAATACATGTGTTCG
GCAAAATTCAAATCACGGA -> CAAAATTCAAATCACGGAT
GCAATTGGTCTTTCCAGTC -> CAATTGGTCTTTCCAGTCG
GCACAACTACCATCGAAAA -> CACAACTACCATCGAAAAC
GCACAATTCCGTATCGTCG -> CACAATTCCGTATCGTCGT
GCACACCGGTCGGGCACTC -> CACACCGGTCGGGCACTCC
GCACAGGACCTACCGCTAA -> CACAGGACCTACCGCTAAA
GCACAGTGGTTCAGGAAGT -> CACAGTGGTTCAGGAAGTG
GCACCCAGTCCTTGTGAAG -> CACCCAGTCCTTGTGAAGT
GCACGCTTTCAGACCAGTC -> CACGCTTTCAGACCAGTCT
GCACGGTAGTTGGTCCTCA -> CACGGTAGTTGGTCCTCAA
GCACGTACTGAAAAGTCTG -> CACGTACTGAAAAGTCTGA
GCACGTCGGGTGTTGCCCT -> CACGTCGGGTGTTGCCCTG
GCACGTTTGGTCCGAGCGG -> CACGTTTGGTCCGAGCGGT
GCACTAAGGTCGGGCCACC -> CACTAAGGTCGGGCCACCG
GCACTCCACTGTGCTGTGC -> CACTCCACTGTGCTGTGCC
GCAGACACTTCGATTAGCC -> CAGACACTTCGATTAGCCA
GCAGAGCGTCACAGCCCCG -> CAGAGCGTCACAGCCCCGA
GCAGCTTCTATCATCAGAT -> CAGCTTCTATCATCAGATT
GCAGGGTTAAGGGCAATTG -> CAGGGTTAAGGGCAATTGG
GCAGGTCGGAAGTCAAGAC -> CAGGTCGGAAGTCAAGACC
GCAGTATCCCGGCGCTAGC -> CAGTATCCCGGCGCTAGCG
GCAGTCCTGCACGGTAGTT -> CAGTCCTGCACGGTAGTTG
GCATAAGATCCGAGAAAGC -> CATAAGATCCGAGAAAGCA
GCATCAACGTAAGAGCTGA -> CATCAACGTAAGAGCTGAT
GCATCAGATTTTAATACAT -> CATCAGATTTTAATACATG,CATCAGATTTTAATACATG
GCATCAGGCGCGGGTTTTA -> CATCAGGCGCGGGTTTTAC
GCATCCAATAAAGACCCAT -> CATCCAATAAAGACCCATA
GCATCCCCATATCATCAGA -> CATCCCCATATCATCAGAT
GCATCCTAAAGTTTTGATC -> CATCCTAAAGTTTTGATCC
GCATCGGAATCAGCGAAAT -> CATCGGAATCAGCGAAATA
GCATCTAGTCTACGTATCC -> CATCTAGTCTACGTATCCT
GCATGAAGCTGGCGCCGGC -> CATGAAGCTGGCGCCGGCT
GCATGCTCACCGATGCATC -> CATGCTCACCGATGCATCC
GCATTAAGAAGGCCACTTG -> CATTAAGAAGGCCACTTGT
GCATTAGTAATTTCGGGGG -> CATTAGTAATTTCGGGGGC
GCCACACGTTTGTACTGTG -> CCACACGTTTGTACTGTGT
GCCACATGCTGTCAACGCA -> CCACATGCTGTCAACGCAC
GCCACCGTTCAGCATGAAG -> CCACCGTTCAGCATGAAGC
GCCACGCAGTATCCCGGCG -> CCACGCAGTATCCCGGCGC
GCCACTCGCCCGACGGAGA -> CCACTCGCCCGACGGAGAG
GCCACTTGTACAATTCACA -> CCACTTGTACAATTCACAC
GCCAGTTTAATCTGTAAGA -> CCAGTTTAATCTGTAAGAG
GCCCACGCTACACCGATAG -> CCCACGCTACACCGATAGG
GCCCCATCCCTTACTGATC -> CCCCATCCCTTACTGATCT
GCCCCGAGGAGAACTGGTC -> CCCCGAGGAGAACTGGTCC
GCCCCGCACGTTTGGTCCG -> CCCCGCACGTTTGGTCCGA
GCCCGACGGAGAGCGCCTT -> CCCGACGGAGAGCGCCTTG
GCCCGAGTGGCAGGGTTAA -> CCCGAGTGGCAGGGTTAAG
GCCCTACTAAGGTTAAAGT -> CCCTACTAAGGTTAAAGTT
GCCCTGTATGCGTGCCATA -> CCCTGTATGCGTGCCATAT
GCCGAAGATGTATTAACCT -> CCGAAGATGTATTAACCTG
GCCGATCGGAACGATATTC -> CCGATCGGAACGATATTCA
GCCGCGTGAGAGAAAGCAG -> CCGCGTGAGAGAAAGCAGT
GCCGGCTGATATTCATTAC -> CCGGCTGATATTCATTACC
GCCGGGAAGGTTTACGTAC -> CCGGGAAGGTTTACGTACT
GCCGGTTAGCACGTACTGA -> CCGGTTAGCACGTACTGAA
GCCGTGGTGTACAAGGAAA -> CCGTGGTGTACAAGGAAAA
GCCGTTCGAAACGGTCTTG -> CCGTTCGAAACGGTCTTGA
GCCTCAGCTGGACGACCAG -> CCTCAGCTGGACGACCAGC
GCCTCCGGGTCATCAGGCG -> CCTCCGGGTCATCAGGCGC
GCCTGGACTCCGATACCTA -> CCTGGACTCCGATACCTAA
GCCTGGCCTTAGGACCTGC -> CCTGGCCTTAGGACCTGCA
GCCTTAGGACCTGCACAAT -> CCTTAGGACCTGCACAATT
GCCTTGGAGGAAGGGAGGC -> CCTTGGAGGAAGGGAGGCT
GCCTTTATTTGGGCGTCCG -> CCTTTATTTGGGCGTCCGC
GCGAAATAACTGGTCCGGT -> CGAAATAACTGGTCCGGTT
GCGAAATTTGGAAAGAAAC -> CGAAATTTGGAAAGAAACG
GCGAAGCCAGTTTAATCTG -> CGAAGCCAGTTTAATCTGT
GCGAGGATTAGAAAGAGGG -> CGAGGATTAGAAAGAGGGC
GCGATAGCCGATCGGAACG -> CGATAGCCGATCGGAACGA
GCGATTCTTGGCCTGGCCT -> CGATTCTTGGCCTGGCCTT
GCGCACACCGGTCGGGCAC -> CGCACACCGGTCGGGCACT
GCGCCGGCTGATATTCATT -> CGCCGGCTGATATTCATTA
GCGCCTTGGAGGAAGGGAG -> CGCCTTGGAGGAAGGGAGG
GCGCGAAGCCAGTTTAATC -> CGCGAAGCCAGTTTAATCT
GCGCGGGTTTTACTGTAAG -> CGCGGGTTTTACTGTAAGA
GCGCTAGCGCTATTCTCCA -> CGCTAGCGCTATTCTCCAA
GCGCTATTCTCCAACCACT -> CGCTATTCTCCAACCACTC
GCGCTCCGCCGGGAAGGTT -> CGCTCCGCCGGGAAGGTTT
GCGCTTGTCTTTTGTCAAC -> CGCTTGTCTTTTGTCAACG
GCGGACCGGGGGCATCGGA -> CGGACCGGGGGCATCGGAA
GCGGCCTGGACTCCGATAC -> CGGCCTGGACTCCGATACC
GCGGCTTCTGTTTGGTCTT -> CGGCTTCTGTTTGGTCTTT
GCGGGCATCAGATTTTAAT -> CGGGCATCAGATTTTAATA
GCGGGTTTTACTGTAAGAC -> CGGGTTTTACTGTAAGACA
GCGGTCTCCTGATTGGCGG -> CGGTCTCCTGATTGGCGGC
GCGGTGTGGGGTGTAGGTC -> CGGTGTGGGGTGTAGGTCC
GCGGTTACTCAAAAGTTAC -> CGGTTACTCAAAAGTTACC
GCGGTTGCATTAAGAAGGC -> CGGTTGCATTAAGAAGGCC
GCGGTTGTCAGAAAATCGC -> CGGTTGTCAGAAAATCGCC
GCGTCACAGCCCCGAGGAG -> CGTCACAGCCCCGAGGAGA
GCGTCCGCACCCAGTCCTT -> CGTCCGCACCCAGTCCTTG
GCGTGAGAGAAAGCAGTCC -> CGTGAGAGAAAGCAGTCCT
GCGTTGGCGGTCTCCTGAT -> CGTTGGCGGTCTCCTGATT
GCTAAAATGATAAAGGAGC -> CTAAAATGATAAAGGAGCA
GCTAAACTGCTAGACATTG -> CTAAACTGCTAGACATTGG
GCTACACCGAGAACCTGGT -> CTACACCGAGAACCTGGTT
GCTACACCGATAGGAAATC -> CTACACCGATAGGAAATCG
GCTACGCACAGTGGTTCAG -> CTACGCACAGTGGTTCAGG
GCTACGCGGACCGGGGGCA -> CTACGCGGACCGGGGGCAT
GCTAGACATTGGTGTACAT -> CTAGACATTGGTGTACATA
GCTAGCGCTATTCTCCAAC -> CTAGCGCTATTCTCCAACC
GCTAGGCGGGCATCAGATT -> CTAGGCGGGCATCAGATTT
GCTATGCTCAGAGAAAATG -> CTATGCTCAGAGAAAATGA
GCTATTCTCCAACCACTCC -> CTATTCTCCAACCACTCCC
GCTCACCGATGCATCCTAA -> CTCACCGATGCATCCTAAA
GCTCAGAGAAAATGACCCA -> CTCAGAGAAAATGACCCAG
GCTCCGCCGGGAAGGTTTA -> CTCCGCCGGGAAGGTTTAC
GCTCCGTTAGAACCCGTAG -> CTCCGTTAGAACCCGTAGC
GCTCGAAGTTGGTCTTTCC -> CTCGAAGTTGGTCTTTCCA
GCTCGCATTAGTAATTTCG -> CTCGCATTAGTAATTTCGG
GCTCGCCGTGGTGTACAAG -> CTCGCCGTGGTGTACAAGG
GCTCGCTACGCGGACCGGG -> CTCGCTACGCGGACCGGGG
GCTCTGTAGGCGCTCCGCC -> CTCTGTAGGCGCTCCGCCG
GCTGATATTCATTACCGAG -> CTGATATTCATTACCGAGA
GCTGATCTAGGACTCTGGG -> CTGATCTAGGACTCTGGGT
GCTGGACGACCAGCGATAG -> CTGGACGACCAGCGATAGC
GCTGGCGCCGGCTGATATT -> CTGGCGCCGGCTGATATTC
GCTGTAGCTGTATATTTGC -> CTGTAGCTGTATATTTGCC
GCTGTATATTTGCCGTTCG -> CTGTATATTTGCCGTTCGA
GCTGTCAACGCACGCTTTC -> CTGTCAACGCACGCTTTCA
GCTGTGAAAAGGAGATGTA -> CTGTGAAAAGGAGATGTAT
GCTGTGCCACACGTTTGTA -> CTGTGCCACACGTTTGTAC
GCTTCTATCATCAGATTTT -> CTTCTATCATCAGATTTTA
GCTTCTGTTTGGTCTTTCC -> CTTCTGTTTGGTCTTTCCA
GCTTGTCTTTTGTCAACGC -> CTTGTCTTTTGTCAACGCT
GCTTTACCTTAGAAGAAGT -> CTTTACCTTAGAAGAAGTG
GCTTTAGGAGGGGATCCGA -> CTTTAGGAGGGGATCCGAC
GCTTTCAGACCAGTCTGCA -> CTTTCAGACCAGTCTGCAG
GCTTTCGTATAAGAGCGAA -> CTTTCGTATAAGAGCGAAA
GGAAAATTCTGGTTGCTGT -> GAAAATTCTGGTTGCTGTA
GGAAAGAAACGTTGTGTCT -> GAAAGAAACGTTGTGTCTT
GGAAATCGCCCTACTAAGG -> GAAATCGCCCTACTAAGGT
GGAACACTGTCATAGGGAC -> GAACACTGTCATAGGGACG
GGAACGATATTCAGATTCG -> GAACGATATTCAGATTCGT
GGAAGGGAGGCTACGCACA -> GAAGGGAGGCTACGCACAG
GGAAGGTTTACGTACTGGG -> GAAGGTTTACGTACTGGGC
GGAAGTCAAGACCCCAGTT -> GAAGTCAAGACCCCAGTTT
GGAAGTGCGATTCTTGGCC -> GAAGTGCGATTCTTGGCCT
GGAATCAGCGAAATAACTG -> GAATCAGCGAAATAACTGG
GGACCACGCGGTTACTCAA -> GACCACGCGGTTACTCAAA
GGACCGATCTTTCTTTTTT -> GACCGATCTTTCTTTTTTG
GGACCGGGGGCATCGGAAT -> GACCGGGGGCATCGGAATC
GGACCTACCGCTAAAATGA -> GACCTACCGCTAAAATGAT
GGACCTGCACAATTCCGTA -> GACCTGCACAATTCCGTAT
GGACGACCAGCGATAGCCG -> GACGACCAGCGATAGCCGA
GGACGTAACTTCAGTTACT -> GACGTAACTTCAGTTACTT
GGACGTCTTACTGGTCCCT -> GACGTCTTACTGGTCCCTC
GGACTCCGATACCTAAGGA -> GACTCCGATACCTAAGGAC
GGACTCTGGGTATTGGAAC -> GACTCTGGGTATTGGAACA
GGACTTCGGTAGAATTACT -> GACTTCGGTAGAATTACTG
GGAGAACTGGTCCTGGCCA -> GAGAACTGGTCCTGGCCAC
GGAGAGCGCCTTGGAGGAA -> GAGAGCGCCTTGGAGGAAG
GGAGATGCGCACACCGGTC -> GAGATGCGCACACCGGTCG
GGAGATGTATGTCACGCAT -> GAGATGTATGTCACGCATA
GGAGCAAAATTCAAATCAC -> GAGCAAAATTCAAATCACG
GGAGGAAGGGAGGCTACGC -> GAGGAAGGGAGGCTACGCA
GGAGGAGATGCGCACACCG -> GAGGAGATGCGCACACCGG
GGAGGCTACGCACAGTGGT -> GAGGCTACGCACAGTGGTT
GGAGGGAGGGCGCGAAGCC -> GAGGGAGGGCGCGAAGCCA
GGAGGGCGCGAAGCCAGTT -> GAGGGCGCGAAGCCAGTTT
GGAGGGGATCCGACCTGCA -> GAGGGGATCCGACCTGCAC
GGAGGTCAACGCTCCGTTA -> GAGGTCAACGCTCCGTTAG
GGATCCGACCTGCACTAAG -> GATCCGACCTGCACTAAGG
GGATCGCGAGGATTAGAAA -> GATCGCGAGGATTAGAAAG
GGATGCCACTCGCCCGACG -> GATGCCACTCGCCCGACGG
GGATTAGAAAGAGGGCTAC -> GATTAGAAAGAGGGCTACA
GGCAATTGGTCTTTCCAGT -> GCAATTGGTCTTTCCAGTC
GGCACAGGACCTACCGCTA -> GCACAGGACCTACCGCTAA
GGCACTCCACTGTGCTGTG -> GCACTCCACTGTGCTGTGC
GGCAGCTTCTATCATCAGA -> GCAGCTTCTATCATCAGAT
GGCAGGGTTAAGGGCAATT -> GCAGGGTTAAGGGCAATTG
GGCAGGTCGGAAGTCAAGA -> GCAGGTCGGAAGTCAAGAC
GGCATCAACGTAAGAGCTG -> GCATCAACGTAAGAGCTGA
GGCATCAGATTTTAATACA -> GCATCAGATTTTAATACAT
GGCATCGGAATCAGCGAAA -> GCATCGGAATCAGCGAAAT
GGCCACCGTTCAGCATGAA -> GCCACCGTTCAGCATGAAG
GGCCACGCAGTATCCCGGC -> GCCACGCAGTATCCCGGCG
GGCCACTTGTACAATTCAC -> GCCACTTGTACAATTCACA
GGCCCCATCCCTTACTGAT -> GCCCCATCCCTTACTGATC
GGCCCCGCACGTTTGGTCC -> GCCCCGCACGTTTGGTCCG
GGCCGAAGATGTATTAACC -> GCCGAAGATGTATTAACCT
GGCCTCAGCTGGACGACCA -> GCCTCAGCTGGACGACCAG
GGCCTGGACTCCGATACCT -> GCCTGGACTCCGATACCTA
GGCCTGGCCTTAGGACCTG -> GCCTGGCCTTAGGACCTGC
GGCCTTAGGACCTGCACAA -> GCCTTAGGACCTGCACAAT
GGCGCCGGCTGATATTCAT -> GCGCCGGCTGATATTCATT
GGCGCGAAGCCAGTTTAAT -> GCGCGAAGCCAGTTTAATC
GGCGCGGGTTTTACTGTAA -> GCGCGGGTTTTACTGTAAG
GGCGCTAGCGCTATTCTCC -> GCGCTAGCGCTATTCTCCA
GGCGCTCCGCCGGGAAGGT -> GCGCTCCGCCGGGAAGGTT
GGCGCTTGTCTTTTGTCAA -> GCGCTTGTCTTTTGTCAAC
GGCGGCCTGGACTCCGATA -> GCGGCCTGGACTCCGATAC
GGCGGGCATCAGATTTTAA -> GCGGGCATCAGATTTTAAT
GGCGGTCTCCTGATTGGCG -> GCGGTCTCCTGATTGGCGG
GGCGGTTGCATTAAGAAGG -> GCGGTTGCATTAAGAAGGC
GGCGGTTGTCAGAAAATCG -> GCGGTTGTCAGAAAATCGC
GGCGTCCGCACCCAGTCCT -> GCGTCCGCACCCAGTCCTT
GGCGTTGGCGGTCTCCTGA -> GCGTTGGCGGTCTCCTGAT
GGCTACACCGAGAACCTGG -> GCTACACCGAGAACCTGGT
GGCTACGCACAGTGGTTCA -> GCTACGCACAGTGGTTCAG
GGCTCGCATTAGTAATTTC -> GCTCGCATTAGTAATTTCG
GGCTGATATTCATTACCGA -> GCTGATATTCATTACCGAG
GGCTTCTGTTTGGTCTTTC -> GCTTCTGTTTGGTCTTTCC
GGGAAGGTTTACGTACTGG -> GGAAGGTTTACGTACTGGG
GGGACGTCTTACTGGTCCC -> GGACGTCTTACTGGTCCCT
GGGAGGCTACGCACAGTGG -> GGAGGCTACGCACAGTGGT
GGGAGGGCGCGAAGCCAGT -> GGAGGGCGCGAAGCCAGTT
GGGATCCGACCTGCACTAA -> GGATCCGACCTGCACTAAG
GGGATCGCGAGGATTAGAA -> GGATCGCGAGGATTAGAAA
GGGCAATTGGTCTTTCCAG -> GGCAATTGGTCTTTCCAGT
GGGCACTCCACTGTGCTGT -> GGCACTCCACTGTGCTGTG
GGGCATCAACGTAAGAGCT -> GGCATCAACGTAAGAGCTG
GGGCATCAGATTTTAATAC -> GGCATCAGATTTTAATACA
GGGCATCGGAATCAGCGAA -> GGCATCGGAATCAGCGAAA
GGGCCACCGTTCAGCATGA -> GGCCACCGTTCAGCATGAA
GGGCCCCATCCCTTACTGA -> GGCCCCATCCCTTACTGAT
GGGCGCGAAGCCAGTTTAA -> GGCGCGAAGCCAGTTTAAT
GGGCGGTTGTCAGAAAATC -> GGCGGTTGTCAGAAAATCG
GGGCGTCCGCACCCAGTCC -> GGCGTCCGCACCCAGTCCT
GGGCGTTGGCGGTCTCCTG -> GGCGTTGGCGGTCTCCTGA
GGGCTACACCGAGAACCTG -> GGCTACACCGAGAACCTGG
GGGGATCCGACCTGCACTA -> GGGATCCGACCTGCACTAA
GGGGCATCAACGTAAGAGC -> GGGCATCAACGTAAGAGCT
GGGGCATCGGAATCAGCGA -> GGGCATCGGAATCAGCGAA
GGGGCCCCATCCCTTACTG -> GGGCCCCATCCCTTACTGA
GGGGCGTTGGCGGTCTCCT -> GGGCGTTGGCGGTCTCCTG
GGGGGCATCGGAATCAGCG -> GGGGCATCGGAATCAGCGA
GGGGGCGTTGGCGGTCTCC -> GGGGCGTTGGCGGTCTCCT
GGGGGTCTGTACTCAGCCC -> GGGGTCTGTACTCAGCCCA
GGGGTCTGTACTCAGCCCA -> GGGTCTGTACTCAGCCCAC
GGGGTGTAGGTCCTTCAAC -> GGGTGTAGGTCCTTCAACG
GGGTATTGGAACACTGTCA -> GGTATTGGAACACTGTCAT
GGGTCATCAGGCGCTTGTC -> GGTCATCAGGCGCTTGTCT
GGGTCTGTACTCAGCCCAC -> GGTCTGTACTCAGCCCACG
GGGTGTAGGTCCTTCAACG -> GGTGTAGGTCCTTCAACGC
GGGTGTTGCCCTGTATGCG -> GGTGTTGCCCTGTATGCGT
GGGTTAAGGGCAATTGGTC -> GGTTAAGGGCAATTGGTCT
GGGTTTTACTGTAAGACAC -> GGTTTTACTGTAAGACACG
GGTAGAATTACTGTATTGG -> GTAGAATTACTGTATTGGG
GGTAGTTGGTCCTCAATCT -> GTAGTTGGTCCTCAATCTC
GGTATTGGAACACTGTCAT -> GTATTGGAACACTGTCATA
GGTCAACGCTCCGTTAGAA -> GTCAACGCTCCGTTAGAAC
GGTCATCAGGCGCTTGTCT -> GTCATCAGGCGCTTGTCTT
GGTCCCTCTCGCTAAACTG -> GTCCCTCTCGCTAAACTGC
GGTCCGAGCGGTGTGGGGT -> GTCCGAGCGGTGTGGGGTG
GGTCCGGTTCCGACACGGA -> GTCCGGTTCCGACACGGAC
GGTCCTCAATCTCCCCGCT -> GTCCTCAATCTCCCCGCTC
GGTCCTGGCCACGCAGTAT -> GTCCTGGCCACGCAGTATC
GGTCCTTCAACGCATCTAG -> GTCCTTCAACGCATCTAGT
GGTCGATCCACGTCTCATG -> GTCGATCCACGTCTCATGT
GGTCGGAAGTCAAGACCCC -> GTCGGAAGTCAAGACCCCA
GGTCGGGCACTCCACTGTG -> GTCGGGCACTCCACTGTGC
GGTCGGGCCACCGTTCAGC -> GTCGGGCCACCGTTCAGCA
GGTCTCCTGATTGGCGGCC -> GTCTCCTGATTGGCGGCCT
GGTCTGTACTCAGCCCACG -> GTCTGTACTCAGCCCACGC
GGTCTTGAGCTGTGAAAAG -> GTCTTGAGCTGTGAAAAGG
GGTCTTTCCAGTCGAGAGC -> GTCTTTCCAGTCGAGAGCT
GGTCTTTCCAGTCGAGCAT -> GTCTTTCCAGTCGAGCATC
GGTCTTTCCAGTCGAGGCA -> GTCTTTCCAGTCGAGGCAG
GGTCTTTCCAGTCGAGTTC -> GTCTTTCCAGTCGAGTTCC
GGTGGCAGGTCGGAAGTCA -> GTGGCAGGTCGGAAGTCAA
GGTGGTCGATCCACGTCTC -> GTGGTCGATCCACGTCTCA
GGTGTACAAGGAAAATTCT -> GTGTACAAGGAAAATTCTG
GGTGTACATAGTATGCCGG -> GTGTACATAGTATGCCGGT
GGTGTAGGTCCTTCAACGC -> GTGTAGGTCCTTCAACGCA
GGTGTGGGGTGTAGGTCCT -> GTGTGGGGTGTAGGTCCTT
GGTGTTGCCCTGTATGCGT -> GTGTTGCCCTGTATGCGTG
GGTTAAAGTTAAAAAATAA -> GTTAAAGTTAAAAAATAAG
GGTTAAGGGCAATTGGTCT -> GTTAAGGGCAATTGGTCTT
GGTTACTCAAAAGTTACCC -> GTTACTCAAAAGTTACCCC
GGTTAGCACGTACTGAAAA -> GTTAGCACGTACTGAAAAG
GGTTCAGGAAGTGCGATTC -> GTTCAGGAAGTGCGATTCT
GGTTCCGACACGGACGTAA -> GTTCCGACACGGACGTAAC
GGTTGCATTAAGAAGGCCA -> GTTGCATTAAGAAGGCCAC
GGTTGCTATGCTCAGAGAA -> GTTGCTATGCTCAGAGAAA
GGTTGCTGTAGCTGTATAT -> GTTGCTGTAGCTGTATATT
GGTTGTCAGAAAATCGCCG -> GTTGTCAGAAAATCGCCGC
GGTTTACGTACTGGGCGGT -> GTTTACGTACTGGGCGGTT
GGTTTTACTGTAAGACACG -> GTTTTACTGTAAGACACGA
GTAACTTCAGTTACTTAGC -> TAACTTCAGTTACTTAGCC
GTAAGACACGAATGAATGA -> TAAGACACGAATGAATGAC
GTAAGAGCTGATCTAGGAC -> TAAGAGCTGATCTAGGACT
GTAAGAGGCCCCGCACGTT -> TAAGAGGCCCCGCACGTTT
GTAATTTCGGGGGCGTTGG -> TAATTTCGGGGGCGTTGGC
GTACAAGGAAAATTCTGGT -> TACAAGGAAAATTCTGGTT
GTACAATTCACACTACACT -> TACAATTCACACTACACTG
GTACATAGTATGCCGGTTA -> TACATAGTATGCCGGTTAG
GTACCTAATAGGGGCCCCA -> TACCTAATAGGGGCCCCAT
GTACTCAGCCCACGCTACA -> TACTCAGCCCACGCTACAC
GTACTGAAAAGTCTGAACT -> TACTGAAAAGTCTGAACTA
GTACTGGGCGGTTGTCAGA -> TACTGGGCGGTTGTCAGAA
GTACTGTGTGTCCAATACT -> TACTGTGTGTCCAATACTT
GTAGAATTACTGTATTGGG -> TAGAATTACTGTATTGGGA
GTAGACTGGAGGTCAACGC -> TAGACTGGAGGTCAACGCT
GTAGAGGTGGCAGGTCGGA -> TAGAGGTGGCAGGTCGGAA
GTAGCCTCCGGGTCATCAG -> TAGCCTCCGGGTCATCAGG
GTAGCTGTATATTTGCCGT -> TAGCTGTATATTTGCCGTT
GTAGGCGCTCCGCCGGGAA -> TAGGCGCTCCGCCGGGAAG
GTAGGTCCTTCAACGCATC -> TAGGTCCTTCAACGCATCT
GTAGTTGGTCCTCAATCTC -> TAGTTGGTCCTCAATCTCC
GTATAAGAGCGAAATTTGG -> TATAAGAGCGAAATTTGGA
GTATATTTGCCGTTCGAAA -> TATATTTGCCGTTCGAAAC
GTATCCCGGCGCTAGCGCT -> TATCCCGGCGCTAGCGCTA
GTATCCTATGATGGCACAG -> TATCCTATGATGGCACAGG
GTATCGTCGTGGCCTCAGC -> TATCGTCGTGGCCTCAGCT
GTATGCCGGTTAGCACGTA -> TATGCCGGTTAGCACGTAC
GTATGCTCGCTACGCGGAC -> TATGCTCGCTACGCGGACC
GTATGTCACGCATAAGATC -> TATGTCACGCATAAGATCC
GTATTAACCTGTGGCGGTT -> TATTAACCTGTGGCGGTTG
GTATTGGAACACTGTCATA -> TATTGGAACACTGTCATAG
GTATTGGGATCGCGAGGAT -> TATTGGGATCGCGAGGATT
GTCAACGCACGCTTTCAGA -> TCAACGCACGCTTTCAGAC
GTCAACGCTCCGTTAGAAC -> TCAACGCTCCGTTAGAACC
GTCAACGCTCTGTAGGCGC -> TCAACGCTCTGTAGGCGCT
GTCAAGAAAAACCAACTAT -> TCAAGAAAAACCAACTATC
GTCAAGACCCCAGTTTTAA -> TCAAGACCCCAGTTTTAAA
GTCACAGCCCCGAGGAGAA -> TCACAGCCCCGAGGAGAAC
GTCACCTGAGTCCGCACGT -> TCACCTGAGTCCGCACGTC
GTCACGCATAAGATCCGAG -> TCACGCATAAGATCCGAGA
GTCACTTAGTACCTAATAG -> TCACTTAGTACCTAATAGG
GTCAGAAAATCGCCGCGTG -> TCAGAAAATCGCCGCGTGA
GTCATAGGGACGTCTTACT -> TCATAGGGACGTCTTACTG
GTCATCAGGCGCTTGTCTT -> TCATCAGGCGCTTGTCTTT
GTCCAATACTTGCATCCAA -> TCCAATACTTGCATCCAAT
GTCCCTCTCGCTAAACTGC -> TCCCTCTCGCTAAACTGCT
GTCCGAGCGGTGTGGGGTG -> TCCGAGCGGTGTGGGGTGT
GTCCGCACCCAGTCCTTGT -> TCCGCACCCAGTCCTTGTG
GTCCGCACGTCGGGTGTTG -> TCCGCACGTCGGGTGTTGC
GTCCGGTTCCGACACGGAC -> TCCGGTTCCGACACGGACG
GTCCTCAATCTCCCCGCTC -> TCCTCAATCTCCCCGCTCG
GTCCTGCACGGTAGTTGGT -> TCCTGCACGGTAGTTGGTC
GTCCTGGCCACGCAGTATC -> TCCTGGCCACGCAGTATCC
GTCCTTCAACGCATCTAGT -> TCCTTCAACGCATCTAGTC
GTCCTTGTGAAGTAGACTG -> TCCTTGTGAAGTAGACTGG
GTCGAGAGCTAGGCGGGCA -> TCGAGAGCTAGGCGGGCAT
GTCGAGCATCCCCATATCA -> TCGAGCATCCCCATATCAT
GTCGAGGCAGCTTCTATCA -> TCGAGGCAGCTTCTATCAT
GTCGAGTTCCATCCGTGCA -> TCGAGTTCCATCCGTGCAT
GTCGATCCACGTCTCATGT -> TCGATCCACGTCTCATGTA
GTCGGAAGTCAAGACCCCA -> TCGGAAGTCAAGACCCCAG
GTCGGAGGGAGGGCGCGAA -> TCGGAGGGAGGGCGCGAAG
GTCGGGCACTCCACTGTGC -> TCGGGCACTCCACTGTGCT
GTCGGGCCACCGTTCAGCA -> TCGGGCCACCGTTCAGCAT
GTCGGGTGTTGCCCTGTAT -> TCGGGTGTTGCCCTGTATG
GTCGTGGCCTCAGCTGGAC -> TCGTGGCCTCAGCTGGACG
GTCTACGTATCCTATGATG -> TCTACGTATCCTATGATGG
GTCTCATGTAGAGGTGGCA -> TCTCATGTAGAGGTGGCAG
GTCTCCTCTAAGTCACTTA -> TCTCCTCTAAGTCACTTAG
GTCTCCTGATTGGCGGCCT -> TCTCCTGATTGGCGGCCTG
GTCTGAACTACAGTGTCTC -> TCTGAACTACAGTGTCTCC
GTCTGCAGAGCGTCACAGC -> TCTGCAGAGCGTCACAGCC
GTCTGTACTCAGCCCACGC -> TCTGTACTCAGCCCACGCT
GTCTTACTGGTCCCTCTCG -> TCTTACTGGTCCCTCTCGC
GTCTTCCGACTTACGTTCT -> TCTTCCGACTTACGTTCTA
GTCTTGAGCTGTGAAAAGG -> TCTTGAGCTGTGAAAAGGA
GTCTTTCCAGTCGAGAGCT -> TCTTTCCAGTCGAGAGCTA
GTCTTTCCAGTCGAGCATC -> TCTTTCCAGTCGAGCATCC
GTCTTTCCAGTCGAGGCAG -> TCTTTCCAGTCGAGGCAGC
GTCTTTCCAGTCGAGTTCC -> TCTTTCCAGTCGAGTTCCA
GTCTTTTGTCAACGCTCTG -> TCTTTTGTCAACGCTCTGT
GTGAAAAGGAGATGTATGT -> TGAAAAGGAGATGTATGTC
GTGAAGTAGACTGGAGGTC -> TGAAGTAGACTGGAGGTCA
GTGAGAGAAAGCAGTCCTG -> TGAGAGAAAGCAGTCCTGC
GTGCATCAGATTTTAATAC -> TGCATCAGATTTTAATACA
GTGCCACACGTTTGTACTG -> TGCCACACGTTTGTACTGT
GTGCGATTCTTGGCCTGGC -> TGCGATTCTTGGCCTGGCC
GTGCTGTGCCACACGTTTG -> TGCTGTGCCACACGTTTGT
GTGCTTTCGTATAAGAGCG -> TGCTTTCGTATAAGAGCGA
GTGGCAGGGTTAAGGGCAA -> TGGCAGGGTTAAGGGCAAT
GTGGCAGGTCGGAAGTCAA -> TGGCAGGTCGGAAGTCAAG
GTGGCCTCAGCTGGACGAC -> TGGCCTCAGCTGGACGACC
GTGGCGGTTGCATTAAGAA -> TGGCGGTTGCATTAAGAAG
GTGGCTCGCATTAGTAATT -> TGGCTCGCATTAGTAATTT
GTGGGGCATCAACGTAAGA -> TGGGGCATCAACGTAAGAG
GTGGGGTGTAGGTCCTTCA -> TGGGGTGTAGGTCCTTCAA
GTGGTCGATCCACGTCTCA -> TGGTCGATCCACGTCTCAT
GTGGTGTACAAGGAAAATT -> TGGTGTACAAGGAAAATTC
GTGGTTCAGGAAGTGCGAT -> TGGTTCAGGAAGTGCGATT
GTGTACAAGGAAAATTCTG -> TGTACAAGGAAAATTCTGG
GTGTACATAGTATGCCGGT -> TGTACATAGTATGCCGGTT
GTGTAGGTCCTTCAACGCA -> TGTAGGTCCTTCAACGCAT
GTGTCCAATACTTGCATCC -> TGTCCAATACTTGCATCCA
GTGTCTCCTCTAAGTCACT -> TGTCTCCTCTAAGTCACTT
GTGTCTTCCGACTTACGTT -> TGTCTTCCGACTTACGTTC
GTGTGGGGTGTAGGTCCTT -> TGTGGGGTGTAGGTCCTTC
GTGTGTCCAATACTTGCAT -> TGTGTCCAATACTTGCATC
GTGTTCGCATGCTCACCGA -> TGTTCGCATGCTCACCGAT
GTGTTGCCCTGTATGCGTG -> TGTTGCCCTGTATGCGTGC
GTTAAAAAATAAGAGGCCG -> TTAAAAAATAAGAGGCCGA
GTTAAAGTTAAAAAATAAG -> TTAAAGTTAAAAAATAAGA
GTTAAGGGCAATTGGTCTT -> TTAAGGGCAATTGGTCTTT
GTTACCCCGTCGGAGGGAG -> TTACCCCGTCGGAGGGAGG
GTTACTCAAAAGTTACCCC -> TTACTCAAAAGTTACCCCG
GTTACTTAGCCCGAGTGGC -> TTACTTAGCCCGAGTGGCA
GTTAGAACCCGTAGCCTCC -> TTAGAACCCGTAGCCTCCG
GTTAGCACGTACTGAAAAG -> TTAGCACGTACTGAAAAGT
GTTCACACTGGACCACGCG -> TTCACACTGGACCACGCGG
GTTCAGCATGAAGCTGGCG -> TTCAGCATGAAGCTGGCGC
GTTCAGGAAGTGCGATTCT -> TTCAGGAAGTGCGATTCTT
GTTCATCAGGTGGTCGATC -> TTCATCAGGTGGTCGATCC
GTTCCATCCGTGCATCAGA -> TTCCATCCGTGCATCAGAT
GTTCCGACACGGACGTAAC -> TTCCGACACGGACGTAACT
GTTCGAAACGGTCTTGAGC -> TTCGAAACGGTCTTGAGCT
GTTCGCATGCTCACCGATG -> TTCGCATGCTCACCGATGC
GTTCTAAGTATGCTCGCTA -> TTCTAAGTATGCTCGCTAC
GTTGCATTAAGAAGGCCAC -> TTGCATTAAGAAGGCCACT
GTTGCCCTGTATGCGTGCC -> TTGCCCTGTATGCGTGCCA
GTTGCTATGCTCAGAGAAA -> TTGCTATGCTCAGAGAAAA
GTTGCTGTAGCTGTATATT -> TTGCTGTAGCTGTATATTT
GTTGGCGGTCTCCTGATTG -> TTGGCGGTCTCCTGATTGG
GTTGGTCCTCAATCTCCCC -> TTGGTCCTCAATCTCCCCG
GTTGGTCTTTCCAGTCGAG -> TTGGTCTTTCCAGTCGAGG
GTTGTCAGAAAATCGCCGC -> TTGTCAGAAAATCGCCGCG
GTTGTGTCTTCCGACTTAC -> TTGTGTCTTCCGACTTACG
GTTTAATCTGTAAGAGGCC -> TTTAATCTGTAAGAGGCCC
GTTTACGTACTGGGCGGTT -> TTTACGTACTGGGCGGTTG
GTTTGGTCCGAGCGGTGTG -> TTTGGTCCGAGCGGTGTGG
GTTTGGTCTTTCCAGTCGA -> TTTGGTCTTTCCAGTCGAG
GTTTGTACTGTGTGTCCAA -> TTTGTACTGTGTGTCCAAT
GTTTTAAATCCTACGACAG -> TTTTAAATCCTACGACAGC
GTTTTACTGTAAGACACGA -> TTTTACTGTAAGACACGAA
GTTTTGATCCAGAGTGCTT -> TTTTGATCCAGAGTGCTTT
TAAAAAATAAGAGGCCGAA -> AAAAAATAAGAGGCCGAAG
TAAAATGATAAAGGAGCAA -> AAAATGATAAAGGAGCAAA
TAAACTGCTAGACATTGGT -> AAACTGCTAGACATTGGTG
TAAAGACCCATATGACTGC -> AAAGACCCATATGACTGCT
TAAAGGAGCAAAATTCAAA -> AAAGGAGCAAAATTCAAAT
TAAAGTTAAAAAATAAGAG -> AAAGTTAAAAAATAAGAGG
TAAAGTTTTGATCCAGAGT -> AAAGTTTTGATCCAGAGTG
TAAATCCTACGACAGCGGC -> AAATCCTACGACAGCGGCT
TAACCTGTGGCGGTTGCAT -> AACCTGTGGCGGTTGCATT
TAACTGGTCCGGTTCCGAC -> AACTGGTCCGGTTCCGACA
TAACTTCAGTTACTTAGCC -> AACTTCAGTTACTTAGCCC
TAAGAAGGCCACTTGTACA -> AAGAAGGCCACTTGTACAA
TAAGACACGAATGAATGAC -> AAGACACGAATGAATGACT
TAAGAGCGAAATTTGGAAA -> AAGAGCGAAATTTGGAAAG
TAAGAGCTGATCTAGGACT -> AAGAGCTGATCTAGGACTC
TAAGAGGCCCCGCACGTTT -> AAGAGGCCCCGCACGTTTG
TAAGAGGCCGAAGATGTAT -> AAGAGGCCGAAGATGTATT
TAAGATCCGAGAAAGCAGA -> AAGATCCGAGAAAGCAGAC
TAAGGACTTCGGTAGAATT -> AAGGACTTCGGTAGAATTA
TAAGGGCAATTGGTCTTTC -> AAGGGCAATTGGTCTTTCC
TAAGGTCGGGCCACCGTTC -> AAGGTCGGGCCACCGTTCA
TAAGGTTAAAGTTAAAAAA -> AAGGTTAAAGTTAAAAAAT
TAAGTATGCTCGCTACGCG -> AAGTATGCTCGCTACGCGG
TAAGTCACTTAGTACCTAA -> AAGTCACTTAGTACCTAAT
TAATACATGAGCTTTACCT -> AATACATGAGCTTTACCTT
TAATACATGATTCGTCAAG -> AATACATGATTCGTCAAGA
TAATACATGCTTTAGGAGG -> AATACATGCTTTAGGAGGG
TAATACATGTGTTCGCATG -> AATACATGTGTTCGCATGC
TAATAGGGGCCCCATCCCT -> AATAGGGGCCCCATCCCTT
TAATCTGTAAGAGGCCCCG -> AATCTGTAAGAGGCCCCGC
TAATTTCGGGGGCGTTGGC -> AATTTCGGGGGCGTTGGCG
TACAAGGAAAATTCTGGTT -> ACAAGGAAAATTCTGGTTG
TACAATTCACACTACACTG -> ACAATTCACACTACACTGG
TACACCGAGAACCTGGTTG -> ACACCGAGAACCTGGTTGC
TACACCGATAGGAAATCGC -> ACACCGATAGGAAATCGCC
TACACTGAAGGAGGAGATG -> ACACTGAAGGAGGAGATGC
TACACTGGACCGATCTTTC -> ACACTGGACCGATCTTTCT
TACAGTGTCTCCTCTAAGT -> ACAGTGTCTCCTCTAAGTC
TACATAGTATGCCGGTTAG -> ACATAGTATGCCGGTTAGC
TACATGAGCTTTACCTTAG -> ACATGAGCTTTACCTTAGA
TACATGATTCGTCAAGAAA -> ACATGATTCGTCAAGAAAA
TACATGCTTTAGGAGGGGA -> ACATGCTTTAGGAGGGGAT
TACATGTGTTCGCATGCTC -> ACATGTGTTCGCATGCTCA
TACCATCGAAAACTTTAGG -> ACCATCGAAAACTTTAGGG
TACCCCGTCGGAGGGAGGG -> ACCCCGTCGGAGGGAGGGC
TACCGAGAAACAATACACT -> ACCGAGAAACAATACACTG
TACCGCTAAAATGATAAAG -> ACCGCTAAAATGATAAAGG
TACCTAAGGACTTCGGTAG -> ACCTAAGGACTTCGGTAGA
TACCTAATAGGGGCCCCAT -> ACCTAATAGGGGCCCCATC
TACCTTAGAAGAAGTGGCT -> ACCTTAGAAGAAGTGGCTC
TACGACAGCGGCTTCTGTT -> ACGACAGCGGCTTCTGTTT
TACGCACAGTGGTTCAGGA -> ACGCACAGTGGTTCAGGAA
TACGCGGACCGGGGGCATC -> ACGCGGACCGGGGGCATCG
TACGTACTGGGCGGTTGTC -> ACGTACTGGGCGGTTGTCA
TACGTATCCTATGATGGCA -> ACGTATCCTATGATGGCAC
TACGTTCTAAGTATGCTCG -> ACGTTCTAAGTATGCTCGC
TACTAAGGTTAAAGTTAAA -> ACTAAGGTTAAAGTTAAAA
TACTCAAAAGTTACCCCGT -> ACTCAAAAGTTACCCCGTC
TACTCAGCCCACGCTACAC -> ACTCAGCCCACGCTACACC
TACTGAAAAGTCTGAACTA -> ACTGAAAAGTCTGAACTAC
TACTGATCTTGGTCTTTCC -> ACTGATCTTGGTCTTTCCA
TACTGGGCGGTTGTCAGAA -> ACTGGGCGGTTGTCAGAAA
TACTGGTCCCTCTCGCTAA -> ACTGGTCCCTCTCGCTAAA
TACTGTAAGACACGAATGA -> ACTGTAAGACACGAATGAA
TACTGTATTGGGATCGCGA -> ACTGTATTGGGATCGCGAG
TACTGTGTGTCCAATACTT -> ACTGTGTGTCCAATACTTG
TACTTAGCCCGAGTGGCAG -> ACTTAGCCCGAGTGGCAGG
TACTTGCATCCAATAAAGA -> ACTTGCATCCAATAAAGAC
TAGAAAGAGGGCTACACCG -> AGAAAGAGGGCTACACCGA
TAGAACCCGTAGCCTCCGG -> AGAACCCGTAGCCTCCGGG
TAGAAGAAGTGGCTCGCAT -> AGAAGAAGTGGCTCGCATT
TAGAATTACTGTATTGGGA -> AGAATTACTGTATTGGGAT
TAGACATTGGTGTACATAG -> AGACATTGGTGTACATAGT
TAGACTGGAGGTCAACGCT -> AGACTGGAGGTCAACGCTC
TAGAGGTGGCAGGTCGGAA -> AGAGGTGGCAGGTCGGAAG
TAGCACGTACTGAAAAGTC -> AGCACGTACTGAAAAGTCT
TAGCCACATGCTGTCAACG -> AGCCACATGCTGTCAACGC
TAGCCCGAGTGGCAGGGTT -> AGCCCGAGTGGCAGGGTTA
TAGCCGATCGGAACGATAT -> AGCCGATCGGAACGATATT
TAGCCTCCGGGTCATCAGG -> AGCCTCCGGGTCATCAGGC
TAGCGCTATTCTCCAACCA -> AGCGCTATTCTCCAACCAC
TAGCTGTATATTTGCCGTT -> AGCTGTATATTTGCCGTTC
TAGGAAATCGCCCTACTAA -> AGGAAATCGCCCTACTAAG
TAGGACCTGCACAATTCCG -> AGGACCTGCACAATTCCGT
TAGGACTCTGGGTATTGGA -> AGGACTCTGGGTATTGGAA
TAGGAGGGGATCCGACCTG -> AGGAGGGGATCCGACCTGC
TAGGCGCTCCGCCGGGAAG -> AGGCGCTCCGCCGGGAAGG
TAGGCGGGCATCAGATTTT -> AGGCGGGCATCAGATTTTA
TAGGGACGTCTTACTGGTC -> AGGGACGTCTTACTGGTCC
TAGGGGCCCCATCCCTTAC -> AGGGGCCCCATCCCTTACT
TAGGGGGTCTGTACTCAGC -> AGGGGGTCTGTACTCAGCC
TAGGTCCTTCAACGCATCT -> AGGTCCTTCAACGCATCTA
TAGTAATTTCGGGGGCGTT -> AGTAATTTCGGGGGCGTTG
TAGTACCTAATAGGGGCCC -> AGTACCTAATAGGGGCCCC
TAGTATGCCGGTTAGCACG -> AGTATGCCGGTTAGCACGT
TAGTCTACGTATCCTATGA -> AGTCTACGTATCCTATGAT
TAGTTCACACTGGACCACG -> AGTTCACACTGGACCACGC
TAGTTGGTCCTCAATCTCC -> AGTTGGTCCTCAATCTCCC
TATAAGAGCGAAATTTGGA -> ATAAGAGCGAAATTTGGAA
TATATTTGCCGTTCGAAAC -> ATATTTGCCGTTCGAAACG
TATCATCAGATTTTAATAC -> ATCATCAGATTTTAATACA,ATCATCAGATTTTAATACA
TATCCCGGCGCTAGCGCTA -> ATCCCGGCGCTAGCGCTAT
TATCCTATGATGGCACAGG -> ATCCTATGATGGCACAGGA
TATCCTGATCAATGCACAA -> ATCCTGATCAATGCACAAC
TATCGTCGTGGCCTCAGCT -> ATCGTCGTGGCCTCAGCTG
TATGACTGCTCGCCGTGGT -> ATGACTGCTCGCCGTGGTG
TATGATGGCACAGGACCTA -> ATGATGGCACAGGACCTAC
TATGCCGGTTAGCACGTAC -> ATGCCGGTTAGCACGTACT
TATGCTCAGAGAAAATGAC -> ATGCTCAGAGAAAATGACC
TATGCTCGCTACGCGGACC -> ATGCTCGCTACGCGGACCG
TATGTCACGCATAAGATCC -> ATGTCACGCATAAGATCCG
TATTAACCTGTGGCGGTTG -> ATTAACCTGTGGCGGTTGC
TATTCAGATTCGTTCATCA -> ATTCAGATTCGTTCATCAG
TATTCATTACCGAGAAACA -> ATTCATTACCGAGAAACAA
TATTCTCCAACCACTCCCC -> ATTCTCCAACCACTCCCCC
TATTGGAACACTGTCATAG -> ATTGGAACACTGTCATAGG
TATTGGGATCGCGAGGATT -> ATTGGGATCGCGAGGATTA
TATTTGCCGTTCGAAACGG -> ATTTGCCGTTCGAAACGGT
TATTTGGGCGTCCGCACCC -> ATTTGGGCGTCCGCACCCA
TCAAAAGTTACCCCGTCGG -> CAAAAGTTACCCCGTCGGA
TCAAATCACGGATGCCACT -> CAAATCACGGATGCCACTC
TCAACGCACGCTTTCAGAC -> CAACGCACGCTTTCAGACC
TCAACGCATCTAGTCTACG -> CAACGCATCTAGTCTACGT
TCAACGCTCCGTTAGAACC -> CAACGCTCCGTTAGAACCC
TCAACGCTCTGTAGGCGCT -> CAACGCTCTGTAGGCGCTC
TCAACGTAAGAGCTGATCT -> CAACGTAAGAGCTGATCTA
TCAAGAAAAACCAACTATC -> CAAGAAAAACCAACTATCC
TCAAGACCCCAGTTTTAAA -> CAAGACCCCAGTTTTAAAT
TCAATCTCCCCGCTCGAAG -> CAATCTCCCCGCTCGAAGT
TCAATGCACAACTACCATC -> CAATGCACAACTACCATCG
TCACACTACACTGGACCGA -> CACACTACACTGGACCGAT
TCACACTGGACCACGCGGT -> CACACTGGACCACGCGGTT
TCACAGCCCCGAGGAGAAC -> CACAGCCCCGAGGAGAACT
TCACCGATGCATCCTAAAG -> CACCGATGCATCCTAAAGT
TCACCTGAGTCCGCACGTC -> CACCTGAGTCCGCACGTCG
TCACGCATAAGATCCGAGA -> CACGCATAAGATCCGAGAA
TCACGGATGCCACTCGCCC -> CACGGATGCCACTCGCCCG
TCACTTAGTACCTAATAGG -> CACTTAGTACCTAATAGGG
TCAGAAAATCGCCGCGTGA -> CAGAAAATCGCCGCGTGAG
TCAGACCAGTCTGCAGAGC -> CAGACCAGTCTGCAGAGCG
TCAGAGAAAATGACCCAGC -> CAGAGAAAATGACCCAGCA
TCAGATTCGTTCATCAGGT -> CAGATTCGTTCATCAGGTG
TCAGATTTTAATACATGAG -> CAGATTTTAATACATGAGC
TCAGATTTTAATACATGAT -> CAGATTTTAATACATGATT
TCAGATTTTAATACATGCT -> CAGATTTTAATACATGCTT
TCAGATTTTAATACATGTG -> CAGATTTTAATACATGTGT
TCAGCATGAAGCTGGCGCC -> CAGCATGAAGCTGGCGCCG
TCAGCCCACGCTACACCGA -> CAGCCCACGCTACACCGAT
TCAGCGAAATAACTGGTCC -> CAGCGAAATAACTGGTCCG
TCAGCTGGACGACCAGCGA -> CAGCTGGACGACCAGCGAT
TCAGGAAGTGCGATTCTTG -> CAGGAAGTGCGATTCTTGG
TCAGGCGCGGGTTTTACTG -> CAGGCGCGGGTTTTACTGT
TCAGGCGCTTGTCTTTTGT -> CAGGCGCTTGTCTTTTGTC
TCAGGTGGTCGATCCACGT -> CAGGTGGTCGATCCACGTC
TCAGTTACTTAGCCCGAGT -> CAGTTACTTAGCCCGAGTG
TCATAGGGACGTCTTACTG -> CATAGGGACGTCTTACTGG
TCATCAGATTTTAATACAT -> CATCAGATTTTAATACATG,CATCAGATTTTAATACATG
TCATCAGGCGCTTGTCTTT -> CATCAGGCGCTTGTCTTTT
TCATCAGGTGGTCGATCCA -> CATCAGGTGGTCGATCCAC
TCATGTAGAGGTGGCAGGT -> CATGTAGAGGTGGCAGGTC
TCATTACCGAGAAACAATA -> CATTACCGAGAAACAATAC
TCCAACCACTCCCCCGCCT -> CCAACCACTCCCCCGCCTT
TCCAATAAAGACCCATATG -> CCAATAAAGACCCATATGA
TCCAATACTTGCATCCAAT -> CCAATACTTGCATCCAATA
TCCACGTCTCATGTAGAGG -> CCACGTCTCATGTAGAGGT
TCCACTGTGCTGTGCCACA -> CCACTGTGCTGTGCCACAC
TCCAGAGTGCTTTCGTATA -> CCAGAGTGCTTTCGTATAA
TCCAGTCGAGAGCTAGGCG -> CCAGTCGAGAGCTAGGCGG
TCCAGTCGAGCATCCCCAT -> CCAGTCGAGCATCCCCATA
TCCAGTCGAGGCAGCTTCT -> CCAGTCGAGGCAGCTTCTA
TCCAGTCGAGTTCCATCCG -> CCAGTCGAGTTCCATCCGT
TCCATCCGTGCATCAGATT -> CCATCCGTGCATCAGATTT
TCCCCATATCATCAGATTT -> CCCCATATCATCAGATTTT
TCCCCCGCCTTTATTTGGG -> CCCCCGCCTTTATTTGGGC
TCCCCGCTCGAAGTTGGTC -> CCCCGCTCGAAGTTGGTCT
TCCCGGCGCTAGCGCTATT -> CCCGGCGCTAGCGCTATTC
TCCCTCTCGCTAAACTGCT -> CCCTCTCGCTAAACTGCTA
TCCCTTACTGATCTTGGTC -> CCCTTACTGATCTTGGTCT
TCCGACACGGACGTAACTT -> CCGACACGGACGTAACTTC
TCCGACCTGCACTAAGGTC -> CCGACCTGCACTAAGGTCG
TCCGACTTACGTTCTAAGT -> CCGACTTACGTTCTAAGTA
TCCGAGAAAGCAGACACTT -> CCGAGAAAGCAGACACTTC
TCCGAGCGGTGTGGGGTGT -> CCGAGCGGTGTGGGGTGTA
TCCGATACCTAAGGACTTC -> CCGATACCTAAGGACTTCG
TCCGCACCCAGTCCTTGTG -> CCGCACCCAGTCCTTGTGA
TCCGCACGTCGGGTGTTGC -> CCGCACGTCGGGTGTTGCC
TCCGCCGGGAAGGTTTACG -> CCGCCGGGAAGGTTTACGT
TCCGGGTCATCAGGCGCTT -> CCGGGTCATCAGGCGCTTG
TCCGGTTCCGACACGGACG -> CCGGTTCCGACACGGACGT
TCCGTATCGTCGTGGCCTC -> CCGTATCGTCGTGGCCTCA
TCCGTGCATCAGATTTTAA -> CCGTGCATCAGATTTTAAT
TCCGTTAGAACCCGTAGCC -> CCGTTAGAACCCGTAGCCT
TCCTAAAGTTTTGATCCAG -> CCTAAAGTTTTGATCCAGA
TCCTACGACAGCGGCTTCT -> CCTACGACAGCGGCTTCTG
TCCTATGATGGCACAGGAC -> CCTATGATGGCACAGGACC
TCCTCAATCTCCCCGCTCG -> CCTCAATCTCCCCGCTCGA
TCCTCTAAGTCACTTAGTA -> CCTCTAAGTCACTTAGTAC
TCCTGATCAATGCACAACT -> CCTGATCAATGCACAACTA
TCCTGATTGGCGGCCTGGA -> CCTGATTGGCGGCCTGGAC
TCCTGCACGGTAGTTGGTC -> CCTGCACGGTAGTTGGTCC
TCCTGGCCACGCAGTATCC -> CCTGGCCACGCAGTATCCC
TCCTTCAACGCATCTAGTC -> CCTTCAACGCATCTAGTCT
TCCTTGTGAAGTAGACTGG -> CCTTGTGAAGTAGACTGGA
TCGAAAACTTTAGGGGGTC -> CGAAAACTTTAGGGGGTCT
TCGAAACGGTCTTGAGCTG -> CGAAACGGTCTTGAGCTGT
TCGAAGTTGGTCTTTCCAG -> CGAAGTTGGTCTTTCCAGT
TCGAGAGCTAGGCGGGCAT -> CGAGAGCTAGGCGGGCATC
TCGAGCATCCCCATATCAT -> CGAGCATCCCCATATCATC
TCGAGGCAGCTTCTATCAT -> CGAGGCAGCTTCTATCATC
TCGAGTTCCATCCGTGCAT -> CGAGTTCCATCCGTGCATC
TCGATCCACGTCTCATGTA -> CGATCCACGTCTCATGTAG
TCGATTAGCCACATGCTGT -> CGATTAGCCACATGCTGTC
TCGCATGCTCACCGATGCA -> CGCATGCTCACCGATGCAT
TCGCATTAGTAATTTCGGG -> CGCATTAGTAATTTCGGGG
TCGCCCGACGGAGAGCGCC -> CGCCCGACGGAGAGCGCCT
TCGCCCTACTAAGGTTAAA -> CGCCCTACTAAGGTTAAAG
TCGCCGCGTGAGAGAAAGC -> CGCCGCGTGAGAGAAAGCA
TCGCCGTGGTGTACAAGGA -> CGCCGTGGTGTACAAGGAA
TCGCGAGGATTAGAAAGAG -> CGCGAGGATTAGAAAGAGG
TCGCTAAACTGCTAGACAT -> CGCTAAACTGCTAGACATT
TCGCTACGCGGACCGGGGG -> CGCTACGCGGACCGGGGGC
TCGGAACGATATTCAGATT -> CGGAACGATATTCAGATTC
TCGGAAGTCAAGACCCCAG -> CGGAAGTCAAGACCCCAGT
TCGGAATCAGCGAAATAAC -> CGGAATCAGCGAAATAACT
TCGGAGGGAGGGCGCGAAG -> CGGAGGGAGGGCGCGAAGC
TCGGGCACTCCACTGTGCT -> CGGGCACTCCACTGTGCTG
TCGGGCCACCGTTCAGCAT -> CGGGCCACCGTTCAGCATG
TCGGGGGCGTTGGCGGTCT -> CGGGGGCGTTGGCGGTCTC
TCGGGTGTTGCCCTGTATG -> CGGGTGTTGCCCTGTATGC
TCGGTAGAATTACTGTATT -> CGGTAGAATTACTGTATTG
TCGTATAAGAGCGAAATTT -> CGTATAAGAGCGAAATTTG
TCGTCAAGAAAAACCAACT -> CGTCAAGAAAAACCAACTA
TCGTCGTGGCCTCAGCTGG -> CGTCGTGGCCTCAGCTGGA
TCGTGGCCTCAGCTGGACG -> CGTGGCCTCAGCTGGACGA
TCGTGGGGCATCAACGTAA -> CGTGGGGCATCAACGTAAG
TCGTTCATCAGGTGGTCGA -> CGTTCATCAGGTGGTCGAT
TCTAAGTATGCTCGCTACG -> CTAAGTATGCTCGCTACGC
TCTAAGTCACTTAGTACCT -> CTAAGTCACTTAGTACCTA
TCTACGTATCCTATGATGG -> CTACGTATCCTATGATGGC
TCTAGGACTCTGGGTATTG -> CTAGGACTCTGGGTATTGG
TCTAGTCTACGTATCCTAT -> CTAGTCTACGTATCCTATG
TCTAGTTCACACTGGACCA -> CTAGTTCACACTGGACCAC
TCTATCATCAGATTTTAAT -> CTATCATCAGATTTTAATA
TCTCATGTAGAGGTGGCAG -> CTCATGTAGAGGTGGCAGG
TCTCCAACCACTCCCCCGC -> CTCCAACCACTCCCCCGCC
TCTCCCCGCTCGAAGTTGG -> CTCCCCGCTCGAAGTTGGT
TCTCCTCTAAGTCACTTAG -> CTCCTCTAAGTCACTTAGT
TCTCCTGATTGGCGGCCTG -> CTCCTGATTGGCGGCCTGG
TCTCGCTAAACTGCTAGAC -> CTCGCTAAACTGCTAGACA
TCTGAACTACAGTGTCTCC -> CTGAACTACAGTGTCTCCT
TCTGCAGAGCGTCACAGCC -> CTGCAGAGCGTCACAGCCC
TCTGGGTATTGGAACACTG -> CTGGGTATTGGAACACTGT
TCTGGTTGCTGTAGCTGTA -> CTGGTTGCTGTAGCTGTAT
TCTGTAAGAGGCCCCGCAC -> CTGTAAGAGGCCCCGCACG
TCTGTACTCAGCCCACGCT -> CTGTACTCAGCCCACGCTA
TCTGTAGGCGCTCCGCCGG -> CTGTAGGCGCTCCGCCGGG
TCTGTTTGGTCTTTCCAGT -> CTGTTTGGTCTTTCCAGTC
TCTTACTGGTCCCTCTCGC -> CTTACTGGTCCCTCTCGCT
TCTTCCGACTTACGTTCTA -> CTTCCGACTTACGTTCTAA
TCTTGAGCTGTGAAAAGGA -> CTTGAGCTGTGAAAAGGAG
TCTTGGCCTGGCCTTAGGA -> CTTGGCCTGGCCTTAGGAC
TCTTGGTCTTTCCAGTCGA -> CTTGGTCTTTCCAGTCGAG
TCTTTCCAGTCGAGAGCTA -> CTTTCCAGTCGAGAGCTAG
TCTTTCCAGTCGAGCATCC -> CTTTCCAGTCGAGCATCCC
TCTTTCCAGTCGAGGCAGC -> CTTTCCAGTCGAGGCAGCT
TCTTTCCAGTCGAGTTCCA -> CTTTCCAGTCGAGTTCCAT
TCTTTCTTTTTTGTCACCT -> CTTTCTTTTTTGTCACCTG
TCTTTTGTCAACGCTCTGT -> CTTTTGTCAACGCTCTGTA
TCTTTTTTGTCACCTGAGT -> CTTTTTTGTCACCTGAGTC
TGAAAAGGAGATGTATGTC -> GAAAAGGAGATGTATGTCA
TGAAAAGTCTGAACTACAG -> GAAAAGTCTGAACTACAGT
TGAACTACAGTGTCTCCTC -> GAACTACAGTGTCTCCTCT
TGAAGCTGGCGCCGGCTGA -> GAAGCTGGCGCCGGCTGAT
TGAAGGAGGAGATGCGCAC -> GAAGGAGGAGATGCGCACA
TGAAGTAGACTGGAGGTCA -> GAAGTAGACTGGAGGTCAA
TGAATGACTCGTGGGGCAT -> GAATGACTCGTGGGGCATC
TGACCCAGCATCAGGCGCG -> GACCCAGCATCAGGCGCGG
TGACTCGTGGGGCATCAAC -> GACTCGTGGGGCATCAACG
TGACTGCTCGCCGTGGTGT -> GACTGCTCGCCGTGGTGTA
TGAGAGAAAGCAGTCCTGC -> GAGAGAAAGCAGTCCTGCA
TGAGCTGTGAAAAGGAGAT -> GAGCTGTGAAAAGGAGATG
TGAGCTTTACCTTAGAAGA -> GAGCTTTACCTTAGAAGAA
TGAGTCCGCACGTCGGGTG -> GAGTCCGCACGTCGGGTGT
TGATAAAGGAGCAAAATTC -> GATAAAGGAGCAAAATTCA
TGATATTCATTACCGAGAA -> GATATTCATTACCGAGAAA
TGATCAATGCACAACTACC -> GATCAATGCACAACTACCA
TGATCCAGAGTGCTTTCGT -> GATCCAGAGTGCTTTCGTA
TGATCTAGGACTCTGGGTA -> GATCTAGGACTCTGGGTAT
TGATCTTGGTCTTTCCAGT -> GATCTTGGTCTTTCCAGTC
TGATGGCACAGGACCTACC -> GATGGCACAGGACCTACCG
TGATTCGTCAAGAAAAACC -> GATTCGTCAAGAAAAACCA
TGATTGGCGGCCTGGACTC -> GATTGGCGGCCTGGACTCC
TGCACAACTACCATCGAAA -> GCACAACTACCATCGAAAA
TGCACAATTCCGTATCGTC -> GCACAATTCCGTATCGTCG
TGCACGGTAGTTGGTCCTC -> GCACGGTAGTTGGTCCTCA
TGCACTAAGGTCGGGCCAC -> GCACTAAGGTCGGGCCACC
TGCAGAGCGTCACAGCCCC -> GCAGAGCGTCACAGCCCCG
TGCATCAGATTTTAATACA -> GCATCAGATTTTAATACAT
TGCATCCAATAAAGACCCA -> GCATCCAATAAAGACCCAT
TGCATCCTAAAGTTTTGAT -> GCATCCTAAAGTTTTGATC
TGCATTAAGAAGGCCACTT -> GCATTAAGAAGGCCACTTG
TGCCACACGTTTGTACTGT -> GCCACACGTTTGTACTGTG
TGCCACTCGCCCGACGGAG -> GCCACTCGCCCGACGGAGA
TGCCCTGTATGCGTGCCAT -> GCCCTGTATGCGTGCCATA
TGCCGGTTAGCACGTACTG -> GCCGGTTAGCACGTACTGA
TGCCGTTCGAAACGGTCTT -> GCCGTTCGAAACGGTCTTG
TGCGATTCTTGGCCTGGCC -> GCGATTCTTGGCCTGGCCT
TGCGCACACCGGTCGGGCA -> GCGCACACCGGTCGGGCAC
TGCTAGACATTGGTGTACA -> GCTAGACATTGGTGTACAT
TGCTATGCTCAGAGAAAAT -> GCTATGCTCAGAGAAAATG
TGCTCACCGATGCATCCTA -> GCTCACCGATGCATCCTAA
TGCTCAGAGAAAATGACCC -> GCTCAGAGAAAATGACCCA
TGCTCGCCGTGGTGTACAA -> GCTCGCCGTGGTGTACAAG
TGCTCGCTACGCGGACCGG -> GCTCGCTACGCGGACCGGG
TGCTGTAGCTGTATATTTG -> GCTGTAGCTGTATATTTGC
TGCTGTCAACGCACGCTTT -> GCTGTCAACGCACGCTTTC
TGCTGTGCCACACGTTTGT -> GCTGTGCCACACGTTTGTA
TGCTTTAGGAGGGGATCCG -> GCTTTAGGAGGGGATCCGA
TGCTTTCGTATAAGAGCGA -> GCTTTCGTATAAGAGCGAA
TGGAAAGAAACGTTGTGTC -> GGAAAGAAACGTTGTGTCT
TGGAACACTGTCATAGGGA -> GGAACACTGTCATAGGGAC
TGGACCACGCGGTTACTCA -> GGACCACGCGGTTACTCAA
TGGACCGATCTTTCTTTTT -> GGACCGATCTTTCTTTTTT
TGGACGACCAGCGATAGCC -> GGACGACCAGCGATAGCCG
TGGACTCCGATACCTAAGG -> GGACTCCGATACCTAAGGA
TGGAGGAAGGGAGGCTACG -> GGAGGAAGGGAGGCTACGC
TGGAGGTCAACGCTCCGTT -> GGAGGTCAACGCTCCGTTA
TGGCACAGGACCTACCGCT -> GGCACAGGACCTACCGCTA
TGGCAGGGTTAAGGGCAAT -> GGCAGGGTTAAGGGCAATT
TGGCAGGTCGGAAGTCAAG -> GGCAGGTCGGAAGTCAAGA
TGGCCACGCAGTATCCCGG -> GGCCACGCAGTATCCCGGC
TGGCCTCAGCTGGACGACC -> GGCCTCAGCTGGACGACCA
TGGCCTGGCCTTAGGACCT -> GGCCTGGCCTTAGGACCTG
TGGCCTTAGGACCTGCACA -> GGCCTTAGGACCTGCACAA
TGGCGCCGGCTGATATTCA -> GGCGCCGGCTGATATTCAT
TGGCGGCCTGGACTCCGAT -> GGCGGCCTGGACTCCGATA
TGGCGGTCTCCTGATTGGC -> GGCGGTCTCCTGATTGGCG
TGGCGGTTGCATTAAGAAG -> GGCGGTTGCATTAAGAAGG
TGGCTCGCATTAGTAATTT -> GGCTCGCATTAGTAATTTC
TGGGATCGCGAGGATTAGA -> GGGATCGCGAGGATTAGAA
TGGGCGGTTGTCAGAAAAT -> GGGCGGTTGTCAGAAAATC
TGGGCGTCCGCACCCAGTC -> GGGCGTCCGCACCCAGTCC
TGGGGCATCAACGTAAGAG -> GGGGCATCAACGTAAGAGC
TGGGGTGTAGGTCCTTCAA -> GGGGTGTAGGTCCTTCAAC
TGGGTATTGGAACACTGTC -> GGGTATTGGAACACTGTCA
TGGTCCCTCTCGCTAAACT -> GGTCCCTCTCGCTAAACTG
TGGTCCGAGCGGTGTGGGG -> GGTCCGAGCGGTGTGGGGT
TGGTCCGGTTCCGACACGG -> GGTCCGGTTCCGACACGGA
TGGTCCTCAATCTCCCCGC -> GGTCCTCAATCTCCCCGCT
TGGTCCTGGCCACGCAGTA -> GGTCCTGGCCACGCAGTAT
TGGTCGATCCACGTCTCAT -> GGTCGATCCACGTCTCATG
TGGTCTTTCCAGTCGAGAG -> GGTCTTTCCAGTCGAGAGC
TGGTCTTTCCAGTCGAGCA -> GGTCTTTCCAGTCGAGCAT
TGGTCTTTCCAGTCGAGGC -> GGTCTTTCCAGTCGAGGCA
TGGTCTTTCCAGTCGAGTT -> GGTCTTTCCAGTCGAGTTC
TGGTGTACAAGGAAAATTC -> GGTGTACAAGGAAAATTCT
TGGTGTACATAGTATGCCG -> GGTGTACATAGTATGCCGG
TGGTTCAGGAAGTGCGATT -> GGTTCAGGAAGTGCGATTC
TGGTTGCTATGCTCAGAGA -> GGTTGCTATGCTCAGAGAA
TGGTTGCTGTAGCTGTATA -> GGTTGCTGTAGCTGTATAT
TGTAAGACACGAATGAATG -> GTAAGACACGAATGAATGA
TGTAAGAGGCCCCGCACGT -> GTAAGAGGCCCCGCACGTT
TGTACAAGGAAAATTCTGG -> GTACAAGGAAAATTCTGGT
TGTACAATTCACACTACAC -> GTACAATTCACACTACACT
TGTACATAGTATGCCGGTT -> GTACATAGTATGCCGGTTA
TGTACTCAGCCCACGCTAC -> GTACTCAGCCCACGCTACA
TGTACTGTGTGTCCAATAC -> GTACTGTGTGTCCAATACT
TGTAGAGGTGGCAGGTCGG -> GTAGAGGTGGCAGGTCGGA
TGTAGCTGTATATTTGCCG -> GTAGCTGTATATTTGCCGT
TGTAGGCGCTCCGCCGGGA -> GTAGGCGCTCCGCCGGGAA
TGTAGGTCCTTCAACGCAT -> GTAGGTCCTTCAACGCATC
TGTATATTTGCCGTTCGAA -> GTATATTTGCCGTTCGAAA
TGTATGTCACGCATAAGAT -> GTATGTCACGCATAAGATC
TGTATTAACCTGTGGCGGT -> GTATTAACCTGTGGCGGTT
TGTATTGGGATCGCGAGGA -> GTATTGGGATCGCGAGGAT
TGTCAACGCACGCTTTCAG -> GTCAACGCACGCTTTCAGA
TGTCAACGCTCTGTAGGCG -> GTCAACGCTCTGTAGGCGC
TGTCACCTGAGTCCGCACG -> GTCACCTGAGTCCGCACGT
TGTCACGCATAAGATCCGA -> GTCACGCATAAGATCCGAG
TGTCAGAAAATCGCCGCGT -> GTCAGAAAATCGCCGCGTG
TGTCATAGGGACGTCTTAC -> GTCATAGGGACGTCTTACT
TGTCCAATACTTGCATCCA -> GTCCAATACTTGCATCCAA
TGTCTCCTCTAAGTCACTT -> GTCTCCTCTAAGTCACTTA
TGTCTTCCGACTTACGTTC -> GTCTTCCGACTTACGTTCT
TGTCTTTTGTCAACGCTCT -> GTCTTTTGTCAACGCTCTG
TGTGAAAAGGAGATGTATG -> GTGAAAAGGAGATGTATGT
TGTGAAGTAGACTGGAGGT -> GTGAAGTAGACTGGAGGTC
TGTGCCACACGTTTGTACT -> GTGCCACACGTTTGTACTG
TGTGCTGTGCCACACGTTT -> GTGCTGTGCCACACGTTTG
TGTGGCGGTTGCATTAAGA -> GTGGCGGTTGCATTAAGAA
TGTGGGGTGTAGGTCCTTC -> GTGGGGTGTAGGTCCTTCA
TGTGTCCAATACTTGCATC -> GTGTCCAATACTTGCATCC
TGTGTCTTCCGACTTACGT -> GTGTCTTCCGACTTACGTT
TGTGTGTCCAATACTTGCA -> GTGTGTCCAATACTTGCAT
TGTGTTCGCATGCTCACCG -> GTGTTCGCATGCTCACCGA
TGTTCGCATGCTCACCGAT -> GTTCGCATGCTCACCGATG
TGTTGCCCTGTATGCGTGC -> GTTGCCCTGTATGCGTGCC
TGTTTGGTCTTTCCAGTCG -> GTTTGGTCTTTCCAGTCGA
TTAAAAAATAAGAGGCCGA -> TAAAAAATAAGAGGCCGAA
TTAAAGTTAAAAAATAAGA -> TAAAGTTAAAAAATAAGAG
TTAAATCCTACGACAGCGG -> TAAATCCTACGACAGCGGC
TTAACCTGTGGCGGTTGCA -> TAACCTGTGGCGGTTGCAT
TTAAGAAGGCCACTTGTAC -> TAAGAAGGCCACTTGTACA
TTAAGGGCAATTGGTCTTT -> TAAGGGCAATTGGTCTTTC
TTAATACATGAGCTTTACC -> TAATACATGAGCTTTACCT
TTAATACATGATTCGTCAA -> TAATACATGATTCGTCAAG
TTAATACATGCTTTAGGAG -> TAATACATGCTTTAGGAGG
TTAATACATGTGTTCGCAT -> TAATACATGTGTTCGCATG
TTAATCTGTAAGAGGCCCC -> TAATCTGTAAGAGGCCCCG
TTACCCCGTCGGAGGGAGG -> TACCCCGTCGGAGGGAGGG
TTACCGAGAAACAATACAC -> TACCGAGAAACAATACACT
TTACCTTAGAAGAAGTGGC -> TACCTTAGAAGAAGTGGCT
TTACGTACTGGGCGGTTGT -> TACGTACTGGGCGGTTGTC
TTACGTTCTAAGTATGCTC -> TACGTTCTAAGTATGCTCG
TTACTCAAAAGTTACCCCG -> TACTCAAAAGTTACCCCGT
TTACTGATCTTGGTCTTTC -> TACTGATCTTGGTCTTTCC
TTACTGGTCCCTCTCGCTA -> TACTGGTCCCTCTCGCTAA
TTACTGTAAGACACGAATG -> TACTGTAAGACACGAATGA
TTACTGTATTGGGATCGCG -> TACTGTATTGGGATCGCGA
TTACTTAGCCCGAGTGGCA -> TACTTAGCCCGAGTGGCAG
TTAGAAAGAGGGCTACACC -> TAGAAAGAGGGCTACACCG
TTAGAACCCGTAGCCTCCG -> TAGAACCCGTAGCCTCCGG
TTAGAAGAAGTGGCTCGCA -> TAGAAGAAGTGGCTCGCAT
TTAGCACGTACTGAAAAGT -> TAGCACGTACTGAAAAGTC
TTAGCCACATGCTGTCAAC -> TAGCCACATGCTGTCAACG
TTAGCCCGAGTGGCAGGGT -> TAGCCCGAGTGGCAGGGTT
TTAGGACCTGCACAATTCC -> TAGGACCTGCACAATTCCG
TTAGGAGGGGATCCGACCT -> TAGGAGGGGATCCGACCTG
TTAGGGGGTCTGTACTCAG -> TAGGGGGTCTGTACTCAGC
TTAGTAATTTCGGGGGCGT -> TAGTAATTTCGGGGGCGTT
TTAGTACCTAATAGGGGCC -> TAGTACCTAATAGGGGCCC
TTATTTGGGCGTCCGCACC -> TATTTGGGCGTCCGCACCC
TTCAAATCACGGATGCCAC -> TCAAATCACGGATGCCACT
TTCAACGCATCTAGTCTAC -> TCAACGCATCTAGTCTACG
TTCACACTACACTGGACCG -> TCACACTACACTGGACCGA
TTCACACTGGACCACGCGG -> TCACACTGGACCACGCGGT
TTCAGACCAGTCTGCAGAG -> TCAGACCAGTCTGCAGAGC
TTCAGATTCGTTCATCAGG -> TCAGATTCGTTCATCAGGT
TTCAGCATGAAGCTGGCGC -> TCAGCATGAAGCTGGCGCC
TTCAGGAAGTGCGATTCTT -> TCAGGAAGTGCGATTCTTG
TTCAGTTACTTAGCCCGAG -> TCAGTTACTTAGCCCGAGT
TTCATCAGGTGGTCGATCC -> TCATCAGGTGGTCGATCCA
TTCATTACCGAGAAACAAT -> TCATTACCGAGAAACAATA
TTCCAGTCGAGAGCTAGGC -> TCCAGTCGAGAGCTAGGCG
TTCCAGTCGAGCATCCCCA -> TCCAGTCGAGCATCCCCAT
TTCCAGTCGAGGCAGCTTC -> TCCAGTCGAGGCAGCTTCT
TTCCAGTCGAGTTCCATCC -> TCCAGTCGAGTTCCATCCG
TTCCATCCGTGCATCAGAT -> TCCATCCGTGCATCAGATT
TTCCGACACGGACGTAACT -> TCCGACACGGACGTAACTT
TTCCGACTTACGTTCTAAG -> TCCGACTTACGTTCTAAGT
TTCCGTATCGTCGTGGCCT -> TCCGTATCGTCGTGGCCTC
TTCGAAACGGTCTTGAGCT -> TCGAAACGGTCTTGAGCTG
TTCGATTAGCCACATGCTG -> TCGATTAGCCACATGCTGT
TTCGCATGCTCACCGATGC -> TCGCATGCTCACCGATGCA
TTCGGGGGCGTTGGCGGTC -> TCGGGGGCGTTGGCGGTCT
TTCGGTAGAATTACTGTAT -> TCGGTAGAATTACTGTATT
TTCGTATAAGAGCGAAATT -> TCGTATAAGAGCGAAATTT
TTCGTCAAGAAAAACCAAC -> TCGTCAAGAAAAACCAACT
TTCGTTCATCAGGTGGTCG -> TCGTTCATCAGGTGGTCGA
TTCTAAGTATGCTCGCTAC -> TCTAAGTATGCTCGCTACG
TTCTATCATCAGATTTTAA -> TCTATCATCAGATTTTAAT
TTCTCCAACCACTCCCCCG -> TCTCCAACCACTCCCCCGC
TTCTGGTTGCTGTAGCTGT -> TCTGGTTGCTGTAGCTGTA
TTCTGTTTGGTCTTTCCAG -> TCTGTTTGGTCTTTCCAGT
TTCTTGGCCTGGCCTTAGG -> TCTTGGCCTGGCCTTAGGA
TTCTTTTTTGTCACCTGAG -> TCTTTTTTGTCACCTGAGT
TTGAGCTGTGAAAAGGAGA -> TGAGCTGTGAAAAGGAGAT
TTGATCCAGAGTGCTTTCG -> TGATCCAGAGTGCTTTCGT
TTGCATCCAATAAAGACCC -> TGCATCCAATAAAGACCCA
TTGCATTAAGAAGGCCACT -> TGCATTAAGAAGGCCACTT
TTGCCCTGTATGCGTGCCA -> TGCCCTGTATGCGTGCCAT
TTGCCGTTCGAAACGGTCT -> TGCCGTTCGAAACGGTCTT
TTGCTATGCTCAGAGAAAA -> TGCTATGCTCAGAGAAAAT
TTGCTGTAGCTGTATATTT -> TGCTGTAGCTGTATATTTG
TTGGAAAGAAACGTTGTGT -> TGGAAAGAAACGTTGTGTC
TTGGAACACTGTCATAGGG -> TGGAACACTGTCATAGGGA
TTGGAGGAAGGGAGGCTAC -> TGGAGGAAGGGAGGCTACG
TTGGCCTGGCCTTAGGACC -> TGGCCTGGCCTTAGGACCT
TTGGCGGCCTGGACTCCGA -> TGGCGGCCTGGACTCCGAT
TTGGCGGTCTCCTGATTGG -> TGGCGGTCTCCTGATTGGC
TTGGGATCGCGAGGATTAG -> TGGGATCGCGAGGATTAGA
TTGGGCGTCCGCACCCAGT -> TGGGCGTCCGCACCCAGTC
TTGGTCCGAGCGGTGTGGG -> TGGTCCGAGCGGTGTGGGG
TTGGTCCTCAATCTCCCCG -> TGGTCCTCAATCTCCCCGC
TTGGTCTTTCCAGTCGAGA -> TGGTCTTTCCAGTCGAGAG
TTGGTCTTTCCAGTCGAGC -> TGGTCTTTCCAGTCGAGCA
TTGGTCTTTCCAGTCGAGG -> TGGTCTTTCCAGTCGAGGC
TTGGTCTTTCCAGTCGAGT -> TGGTCTTTCCAGTCGAGTT
TTGGTGTACATAGTATGCC -> TGGTGTACATAGTATGCCG
TTGTACAATTCACACTACA -> TGTACAATTCACACTACAC
TTGTACTGTGTGTCCAATA -> TGTACTGTGTGTCCAATAC
TTGTCAACGCTCTGTAGGC -> TGTCAACGCTCTGTAGGCG
TTGTCACCTGAGTCCGCAC -> TGTCACCTGAGTCCGCACG
TTGTCAGAAAATCGCCGCG -> TGTCAGAAAATCGCCGCGT
TTGTCTTTTGTCAACGCTC -> TGTCTTTTGTCAACGCTCT
TTGTGAAGTAGACTGGAGG -> TGTGAAGTAGACTGGAGGT
TTGTGTCTTCCGACTTACG -> TGTGTCTTCCGACTTACGT
TTTAAATCCTACGACAGCG -> TTAAATCCTACGACAGCGG
TTTAATACATGAGCTTTAC -> TTAATACATGAGCTTTACC
TTTAATACATGATTCGTCA -> TTAATACATGATTCGTCAA
TTTAATACATGCTTTAGGA -> TTAATACATGCTTTAGGAG
TTTAATACATGTGTTCGCA -> TTAATACATGTGTTCGCAT
TTTAATCTGTAAGAGGCCC -> TTAATCTGTAAGAGGCCCC
TTTACCTTAGAAGAAGTGG -> TTACCTTAGAAGAAGTGGC
TTTACGTACTGGGCGGTTG -> TTACGTACTGGGCGGTTGT
TTTACTGTAAGACACGAAT -> TTACTGTAAGACACGAATG
TTTAGGAGGGGATCCGACC -> TTAGGAGGGGATCCGACCT
TTTAGGGGGTCTGTACTCA -> TTAGGGGGTCTGTACTCAG
TTTATTTGGGCGTCCGCAC -> TTATTTGGGCGTCCGCACC
TTTCAGACCAGTCTGCAGA -> TTCAGACCAGTCTGCAGAG
TTTCCAGTCGAGAGCTAGG -> TTCCAGTCGAGAGCTAGGC
TTTCCAGTCGAGCATCCCC -> TTCCAGTCGAGCATCCCCA
TTTCCAGTCGAGGCAGCTT -> TTCCAGTCGAGGCAGCTTC
TTTCCAGTCGAGTTCCATC -> TTCCAGTCGAGTTCCATCC
TTTCGGGGGCGTTGGCGGT -> TTCGGGGGCGTTGGCGGTC
TTTCGTATAAGAGCGAAAT -> TTCGTATAAGAGCGAAATT
TTTCTTTTTTGTCACCTGA -> TTCTTTTTTGTCACCTGAG
TTTGATCCAGAGTGCTTTC -> TTGATCCAGAGTGCTTTCG
TTTGCCGTTCGAAACGGTC -> TTGCCGTTCGAAACGGTCT
TTTGGAAAGAAACGTTGTG -> TTGGAAAGAAACGTTGTGT
TTTGGGCGTCCGCACCCAG -> TTGGGCGTCCGCACCCAGT
TTTGGTCCGAGCGGTGTGG -> TTGGTCCGAGCGGTGTGGG
TTTGGTCTTTCCAGTCGAG -> TTGGTCTTTCCAGTCGAGT
TTTGTACTGTGTGTCCAAT -> TTGTACTGTGTGTCCAATA
TTTGTCAACGCTCTGTAGG -> TTGTCAACGCTCTGTAGGC
TTTGTCACCTGAGTCCGCA -> TTGTCACCTGAGTCCGCAC
TTTTAAATCCTACGACAGC -> TTTAAATCCTACGACAGCG
TTTTAATACATGAGCTTTA -> TTTAATACATGAGCTTTAC
TTTTAATACATGATTCGTC -> TTTAATACATGATTCGTCA
TTTTAATACATGCTTTAGG -> TTTAATACATGCTTTAGGA
TTTTAATACATGTGTTCGC -> TTTAATACATGTGTTCGCA
TTTTACTGTAAGACACGAA -> TTTACTGTAAGACACGAAT
TTTTGATCCAGAGTGCTTT -> TTTGATCCAGAGTGCTTTC
TTTTGTCAACGCTCTGTAG -> TTTGTCAACGCTCTGTAGG
TTTTGTCACCTGAGTCCGC -> TTTGTCACCTGAGTCCGCA
TTTTTGTCACCTGAGTCCG -> TTTTGTCACCTGAGTCCGC
TTTTTTGTCACCTGAGTCC -> TTTTTGTCACCTGAGTCCG
