AAAACACTCAA -> AAACACTCAAA
AAAAGATGGTG -> AAAGATGGTGA
AAAAGCAATGC -> AAAGCAATGCT
AAAAGCTCAAC -> AAAGCTCAACA
AAAATCACTGC -> AAATCACTGCT
AAAATCCGCTT -> AAATCCGCTTT
AAAATCTGTCC -> AAATCTGTCCA
AAAATTTAGCG -> AAATTTAGCGC
AAACACTCAAA -> AACACTCAAAC
AAACAGAAACA -> AACAGAAACAG
AAACAGATTCG -> AACAGATTCGG
AAACGCTCGGG -> AACGCTCGGGC
AAACTCGCTAG -> AACTCGCTAGC
AAACTTGTGCC -> AACTTGTGCCA
AAAGATGGTGA -> AAGATGGTGAT
AAAGCAATGCT -> AAGCAATGCTT
AAAGCTCAACA -> AAGCTCAACAA
AAAGCTTATTA -> AAGCTTATTAG
AAAGGGTATCA -> AAGGGTATCAT
AAAGTCCCTCC -> AAGTCCCTCCG
AAATACGGGAA -> AATACGGGAAT
AAATCACTGCT -> AATCACTGCTC
AAATCCCCCTG -> AATCCCCCTGA
AAATCCGCTTT -> AATCCGCTTTA
AAATCGCCTGC -> AATCGCCTGCG
AAATCTGTCCA -> AATCTGTCCAA
AAATGACGGTT -> AATGACGGTTT
AAATGAGCCAC -> AATGAGCCACG
AAATGTTGTGT -> AATGTTGTGTT
AAATTGGAACT -> AATTGGAACTG
AAATTTAGCGC -> AATTTAGCGCG
AACAAAAGATG -> ACAAAAGATGG
AACAAGTTGTC -> ACAAGTTGTCT
AACACCCTCAG -> ACACCCTCAGG
AACACTCAAAC -> ACACTCAAACG
AACAGAAACAG -> ACAGAAACAGA
AACAGATTCGG -> ACAGATTCGGA
AACCAAAGTCC -> ACCAAAGTCCC
AACCGCATGTT -> ACCGCATGTTA
AACCGGAGTGA -> ACCGGAGTGAC
AACCGGCAGGA -> ACCGGCAGGAA
AACCGGCGCAA -> ACCGGCGCAAA
AACGATTGTGA -> ACGATTGTGAT
AACGCTCGGGC -> ACGCTCGGGCA
AACGGCTTACT -> ACGGCTTACTA
AACTATCGAGG -> ACTATCGAGGG
AACTCGCTAGC -> ACTCGCTAGCA
AACTCGGTCAA -> ACTCGGTCAAG
AACTGCCTTCA -> ACTGCCTTCAA
AACTGGGCTCG -> ACTGGGCTCGT
AACTGTACCCT -> ACTGTACCCTA
AACTTCACGAA -> ACTTCACGAAA
AACTTCCTAGG -> ACTTCCTAGGC
AACTTGTGCCA -> ACTTGTGCCAG
AACTTTCTCGT -> ACTTTCTCGTC
AAGACCGTGTC -> AGACCGTGTCA
AAGATGGTGAT -> AGATGGTGATA
AAGATTTCGTC -> AGATTTCGTCG
AAGCAATGCTT -> AGCAATGCTTT
AAGCACGCTCC -> AGCACGCTCCA
AAGCACGGCCC -> AGCACGGCCCG
AAGCAGGCACT -> AGCAGGCACTC
AAGCATTTGTG -> AGCATTTGTGA
AAGCCTACGCG -> AGCCTACGCGT
AAGCGGCTGTG -> AGCGGCTGTGC
AAGCTCAACAA -> AGCTCAACAAG
AAGCTGTGCTG -> AGCTGTGCTGC
AAGCTTATTAG -> AGCTTATTAGC
AAGGGCGCTAT -> AGGGCGCTATG
AAGGGGCGAAT -> AGGGGCGAATA
AAGGGTATCAT -> AGGGTATCATT
AAGGTCACGAT -> AGGTCACGATA
AAGTACCACTC -> AGTACCACTCT
AAGTACCTGAT -> AGTACCTGATG
AAGTACGAAAA -> AGTACGAAAAT
AAGTAGAATGC -> AGTAGAATGCA
AAGTCATCCAC -> AGTCATCCACT
AAGTCCCTCCG -> AGTCCCTCCGG
AAGTGATTGGG -> AGTGATTGGGA
AAGTTCCACGA -> AGTTCCACGAT
AAGTTGTCTTT -> AGTTGTCTTTA
AATACGGGAAT -> ATACGGGAATT
AATAGCGCGCC -> ATAGCGCGCCA
AATAGGCACCT -> ATAGGCACCTG
AATATCAGCAA -> ATATCAGCAAG
AATATTACTCC -> ATATTACTCCT
AATATTGGAGG -> ATATTGGAGGG
AATCACTGCTC -> ATCACTGCTCT
AATCCCCCTGA -> ATCCCCCTGAA
AATCCGCTTTA -> ATCCGCTTTAG
AATCGAGTGTC -> ATCGAGTGTCA
AATCGCCTGCG -> ATCGCCTGCGT
AATCTGTCCAA -> ATCTGTCCAAT
AATGACGGTTT -> ATGACGGTTTA
AATGAGCCACG -> ATGAGCCACGT
AATGATTTCAA -> ATGATTTCAAA
AATGCAAGATT -> ATGCAAGATTT
AATGCAGTCCT -> ATGCAGTCCTG
AATGCGCGACG -> ATGCGCGACGA
AATGCTTTTCC -> ATGCTTTTCCC
AATGTTGTGTT -> ATGTTGTGTTA
AATTATCCAGT -> ATTATCCAGTA
AATTCACATCG -> ATTCACATCGT
AATTCCCAGTG -> ATTCCCAGTGC
AATTCTCTTCC -> ATTCTCTTCCT
AATTGCCTTCA -> ATTGCCTTCAC
AATTGGAACTG -> ATTGGAACTGG
AATTTAGCGCG -> ATTTAGCGCGG
AATTTATGGAG -> ATTTATGGAGC
AATTTCATTAC -> ATTTCATTACG
AATTTCTCCCT -> ATTTCTCCCTC
AATTTGGCTAT -> ATTTGGCTATC
ACAAAAGATGG -> CAAAAGATGGT
ACAAATGACGG -> CAAATGACGGT
ACAACCGGCGC -> CAACCGGCGCA
ACAAGTTGTCT -> CAAGTTGTCTT
ACAATCGAGTG -> CAATCGAGTGT
ACAATTTCTCC -> CAATTTCTCCC
ACACCCTCAGG -> CACCCTCAGGG
ACACGAGTCCT -> CACGAGTCCTT
ACACGCTCAGT -> CACGCTCAGTT
ACACGGATTAG -> CACGGATTAGT
ACACGGCACTT -> CACGGCACTTT
ACACGGTCAGG -> CACGGTCAGGA
ACACGTGACCA -> CACGTGACCAC
ACACTCAAACG -> CACTCAAACGC
ACACTTTGAGG -> CACTTTGAGGA
ACAGAAACAGA -> CAGAAACAGAT
ACAGAATTCAC -> CAGAATTCACA
ACAGATTCGGA -> CAGATTCGGAG
ACAGCTCACAC -> CAGCTCACACG
ACAGGCCAGTG -> CAGGCCAGTGG
ACAGGGTCCGA -> CAGGGTCCGAA
ACAGTCCCTGG -> CAGTCCCTGGT
ACAGTCTACCG -> CAGTCTACCGA
ACATCGTCTGT -> CATCGTCTGTG
ACATGTTGGCT -> CATGTTGGCTC
ACCAAAGTCCC -> CCAAAGTCCCT
ACCAATTCTCT -> CCAATTCTCTT
ACCACCGTTCG -> CCACCGTTCGA
ACCACTCTTAG -> CCACTCTTAGC
ACCAGTAACTG -> CCAGTAACTGT
ACCAGTCGCTC -> CCAGTCGCTCC
ACCATACAGTC -> CCATACAGTCT
ACCATGGGCCG -> CCATGGGCCGG
ACCCCATGCAG -> CCCCATGCAGT
ACCCTAGATCC -> CCCTAGATCCT
ACCCTCAGGGG -> CCCTCAGGGGT
ACCCTGGTGAG -> CCCTGGTGAGT
ACCGAACTTCA -> CCGAACTTCAC
ACCGCATGTTA -> CCGCATGTTAA
ACCGGAGTGAC -> CCGGAGTGACC
ACCGGCAGGAA -> CCGGCAGGAAC
ACCGGCGCAAA -> CCGGCGCAAAG
ACCGGGTATCC -> CCGGGTATCCC
ACCGTAAGTCA -> CCGTAAGTCAT
ACCGTAGACCA -> CCGTAGACCAG
ACCGTGTCAGC -> CCGTGTCAGCC
ACCGTTCGAAA -> CCGTTCGAAAA
ACCTAGTTACA -> CCTAGTTACAG
ACCTCATCAAG -> CCTCATCAAGG
ACCTCCTAGCG -> CCTCCTAGCGC
ACCTGAATATC -> CCTGAATATCA
ACCTGAGACCT -> CCTGAGACCTG
ACCTGAGCAAC -> CCTGAGCAACT
ACCTGATATAG -> CCTGATATAGA
ACCTGATGTCA -> CCTGATGTCAG
ACCTGGGGTAC -> CCTGGGGTACC
ACCTGTGGAAC -> CCTGTGGAACG
ACGAAAATCTG -> CGAAAATCTGT
ACGAAATGTTG -> CGAAATGTTGT
ACGAAGACCGT -> CGAAGACCGTG
ACGAGTCCTTA -> CGAGTCCTTAA
ACGATACCAAT -> CGATACCAATT
ACGATCGCGTA -> CGATCGCGTAA
ACGATTGTGAT -> CGATTGTGATT
ACGCGTTAAAC -> CGCGTTAAACT
ACGCTCAGTTT -> CGCTCAGTTTG
ACGCTCCAAAA -> CGCTCCAAAAT
ACGCTCGGGCA -> CGCTCGGGCAG
ACGGATTAGTC -> CGGATTAGTCC
ACGGCACTTTC -> CGGCACTTTCC
ACGGCCCGTCC -> CGGCCCGTCCA
ACGGCCGATGC -> CGGCCGATGCT
ACGGCTCCGGA -> CGGCTCCGGAT
ACGGCTTACTA -> CGGCTTACTAT
ACGGGAATTTG -> CGGGAATTTGG
ACGGTCAGGAC -> CGGTCAGGACT
ACGGTCTAGGC -> CGGTCTAGGCT
ACGGTTTACTC -> CGGTTTACTCA
ACGTAAACTCG -> CGTAAACTCGC
ACGTACTTGAT -> CGTACTTGATA
ACGTGACCACC -> CGTGACCACCG
ACGTTTGATCG -> CGTTTGATCGG
ACTAATTTCAT -> CTAATTTCATT
ACTATCGAGGG -> CTATCGAGGGG
ACTATGCGCCC -> CTATGCGCCCG
ACTCAAACGCT -> CTCAAACGCTC
ACTCAAGCACG -> CTCAAGCACGG
ACTCAGTATCC -> CTCAGTATCCG
ACTCAGTCCGC -> CTCAGTCCGCC
ACTCATCATGA -> CTCATCATGAC
ACTCCCGGTCT -> CTCCCGGTCTC
ACTCCTCATGC -> CTCCTCATGCA
ACTCGCTAGCA -> CTCGCTAGCAC
ACTCGGTCAAG -> CTCGGTCAAGC
ACTCTCGAGGG -> CTCTCGAGGGC
ACTCTTAGCTA -> CTCTTAGCTAC
ACTGCACCTGG -> CTGCACCTGGG
ACTGCCTTCAA -> CTGCCTTCAAA
ACTGCTCTGAT -> CTGCTCTGATT
ACTGGAGCTGC -> CTGGAGCTGCC
ACTGGGCTCGT -> CTGGGCTCGTG
ACTGTACCCTA -> CTGTACCCTAG
ACTGTCCACAG -> CTGTCCACAGG
ACTTACCATAC -> CTTACCATACA
ACTTCACGAAA -> CTTCACGAAAT
ACTTCATCTTT -> CTTCATCTTTT
ACTTCCTAGGC -> CTTCCTAGGCA
ACTTGATAAGC -> CTTGATAAGCA
ACTTGTGCCAG -> CTTGTGCCAGT
ACTTTCCCTTT -> CTTTCCCTTTA
ACTTTCTCGTC -> CTTTCTCGTCA
ACTTTGAGGAT -> CTTTGAGGATG
AGAAACAGAAA -> GAAACAGAAAC
AGAAACAGATT -> GAAACAGATTC
AGAAAGCTTAT -> GAAAGCTTATT
AGAACCGGAGT -> GAACCGGAGTG
AGAATATTACT -> GAATATTACTC
AGAATGCAGTC -> GAATGCAGTCC
AGAATTCACAT -> GAATTCACATC
AGACAATTTCT -> GACAATTTCTC
AGACACGCTCA -> GACACGCTCAG
AGACCAGTAAC -> GACCAGTAACT
AGACCGTGTCA -> GACCGTGTCAG
AGACCTGAATA -> GACCTGAATAT
AGACGTACTTG -> GACGTACTTGA
AGACTCAAGCA -> GACTCAAGCAC
AGAGCAATTGC -> GAGCAATTGCC
AGAGCTCGAGA -> GAGCTCGAGAT
AGAGGGGAGTC -> GAGGGGAGTCG
AGAGTCCAGGT -> GAGTCCAGGTC
AGAGTGGTGCA -> GAGTGGTGCAT
AGATACTGTCC -> GATACTGTCCA
AGATCACGGTC -> GATCACGGTCT
AGATCCTGCTG -> GATCCTGCTGA
AGATCGGAAGT -> GATCGGAAGTA
AGATCTGACAT -> GATCTGACATG
AGATGCTTTCC -> GATGCTTTCCG
AGATGGTGATA -> GATGGTGATAT
AGATTCGGAGA -> GATTCGGAGAG
AGATTGAGAAT -> GATTGAGAATA
AGATTTATGCT -> GATTTATGCTC
AGATTTCGTCG -> GATTTCGTCGG
AGCAACTGCCT -> GCAACTGCCTT
AGCAAGGGCGC -> GCAAGGGCGCT
AGCAATGCTTT -> GCAATGCTTTT
AGCAATTGCCT -> GCAATTGCCTT
AGCACACGGAT -> GCACACGGATT
AGCACAGAATT -> GCACAGAATTC
AGCACGCTCCA -> GCACGCTCCAA
AGCACGGCCCG -> GCACGGCCCGT
AGCAGCCGACC -> GCAGCCGACCA
AGCAGGACAGT -> GCAGGACAGTC
AGCAGGCACTC -> GCAGGCACTCC
AGCATTTGTGA -> GCATTTGTGAA
AGCCACGTAAA -> GCCACGTAAAC
AGCCGACACGG -> GCCGACACGGC
AGCCGACCATG -> GCCGACCATGG
AGCCTACGCGT -> GCCTACGCGTT
AGCGCATAATT -> GCGCATAATTT
AGCGCGCCACC -> GCGCGCCACCG
AGCGCGGTGAG -> GCGCGGTGAGA
AGCGCTGGCTC -> GCGCTGGCTCT
AGCGGCTGTGC -> GCGGCTGTGCC
AGCGTGGATAA -> GCGTGGATAAC
AGCTAAGTAGA -> GCTAAGTAGAA
AGCTACCGGGT -> GCTACCGGGTA
AGCTCAACAAG -> GCTCAACAAGT
AGCTCACACGT -> GCTCACACGTG
AGCTCGAGATT -> GCTCGAGATTT
AGCTGCCGTCT -> GCTGCCGTCTC
AGCTGCCTTGT -> GCTGCCTTGTA
AGCTGGTGCTG -> GCTGGTGCTGG
AGCTGTGCTGC -> GCTGTGCTGCA
AGCTTATTAGC -> GCTTATTAGCT
AGCTTCCACCA -> GCTTCCACCAG
AGCTTGATACT -> GCTTGATACTC
AGGAAAACACT -> GGAAAACACTC
AGGAACTATCG -> GGAACTATCGA
AGGACAGTCCC -> GGACAGTCCCT
AGGACTTACCA -> GGACTTACCAT
AGGATGATGTT -> GGATGATGTTC
AGGCACCTGAG -> GGCACCTGAGA,GGCACCTGAGC
AGGCACTCCCG -> GGCACTCCCGG
AGGCAGGTGGC -> GGCAGGTGGCC
AGGCCAGTGGA -> GGCCAGTGGAT
AGGCTCCATTG -> GGCTCCATTGC
AGGGATCTTAA -> GGGATCTTAAT
AGGGCAATGCG -> GGGCAATGCGC
AGGGCCATTGG -> GGGCCATTGGC
AGGGCGCTATG -> GGGCGCTATGT
AGGGGAGCTTC -> GGGGAGCTTCC
AGGGGAGTCGC -> GGGGAGTCGCG
AGGGGCGAATA -> GGGGCGAATAT
AGGGGCTATCG -> GGGGCTATCGA
AGGGGTGTTAC -> GGGGTGTTACT
AGGGTATCATT -> GGGTATCATTG
AGGGTCCGAAG -> GGGTCCGAAGG
AGGTAAGTACC -> GGTAAGTACCA
AGGTCACGATA -> GGTCACGATAC
AGGTCTCACGG -> GGTCTCACGGC
AGGTGGCCTCG -> GGTGGCCTCGC
AGGTGTTCTGC -> GGTGTTCTGCT
AGTAAAATTTA -> GTAAAATTTAG
AGTAACCGCAT -> GTAACCGCATG
AGTAACTGTAC -> GTAACTGTACC
AGTACCACTCT -> GTACCACTCTT
AGTACCTGATA -> GTACCTGATAT
AGTACCTGATG -> GTACCTGATGT
AGTACGAAAAT -> GTACGAAAATC
AGTAGAATGCA -> GTAGAATGCAG
AGTATCCGACC -> GTATCCGACCT
AGTCATCCACT -> GTCATCCACTC
AGTCCAGGTCT -> GTCCAGGTCTC
AGTCCCCAAGT -> GTCCCCAAGTG
AGTCCCTCCGG -> GTCCCTCCGGT
AGTCCCTGGTA -> GTCCCTGGTAT
AGTCCGCCCAA -> GTCCGCCCAAG
AGTCCTGCGCC -> GTCCTGCGCCT
AGTCCTTAAAT -> GTCCTTAAATA
AGTCGCGGCAC -> GTCGCGGCACA
AGTCGCTCCCG -> GTCGCTCCCGC
AGTCTACCGAA -> GTCTACCGAAC
AGTGACCCCAT -> GTGACCCCATG
AGTGATTGGGA -> GTGATTGGGAA
AGTGCTTGGGC -> GTGCTTGGGCA
AGTGGATCTGT -> GTGGATCTGTC
AGTGGTCTGCG -> GTGGTCTGCGT
AGTGGTGCATC -> GTGGTGCATCG
AGTGTCAGATC -> GTGTCAGATCG
AGTTACAGGGT -> GTTACAGGGTC
AGTTCCACGAT -> GTTCCACGATC
AGTTGACACGA -> GTTGACACGAG
AGTTGTCTTTA -> GTTGTCTTTAC
AGTTTCCGAGA -> GTTTCCGAGAG
AGTTTGTTCAA -> GTTTGTTCAAT
AGTTTTAGAGC -> GTTTTAGAGCA
ATAACAAAAGA -> TAACAAAAGAT
ATAACCAAAGT -> TAACCAAAGTC
ATAAGCACGCT -> TAAGCACGCTC
ATAATTTATGG -> TAATTTATGGA
ATACAGTCTAC -> TACAGTCTACC
ATACCAATTCT -> TACCAATTCTC
ATACGGCCGAT -> TACGGCCGATG
ATACGGGAATT -> TACGGGAATTT
ATACTCATCAT -> TACTCATCATG
ATACTGTCCAC -> TACTGTCCACA
ATAGAAACAGA -> TAGAAACAGAA
ATAGCGCGCCA -> TAGCGCGCCAC
ATAGGCACCTG -> TAGGCACCTGA
ATATAGAAACA -> TATAGAAACAG
ATATCAGCAAG -> TATCAGCAAGG
ATATTACTCCT -> TATTACTCCTC
ATATTGAGATC -> TATTGAGATCA
ATATTGGAGGG -> TATTGGAGGGG
ATCAAGGTCAC -> TCAAGGTCACG
ATCACGGTCTA -> TCACGGTCTAG
ATCACTGCTCT -> TCACTGCTCTG
ATCAGAGTCCA -> TCAGAGTCCAG
ATCAGCAAGGG -> TCAGCAAGGGC
ATCATGACAGC -> TCATGACAGCT
ATCATTGAAGT -> TCATTGAAGTT
ATCCACTCAGT -> TCCACTCAGTA
ATCCAGTACCT -> TCCAGTACCTG
ATCCCCAGAAA -> TCCCCAGAAAG
ATCCCCCGTGG -> TCCCCCGTGGA
ATCCCCCTGAA -> TCCCCCTGAAG
ATCCCTACAAC -> TCCCTACAACC
ATCCGACCTCA -> TCCGACCTCAT
ATCCGCTTTAG -> TCCGCTTTAGA
ATCCGGCACTC -> TCCGGCACTCT
ATCCTGCTGAG -> TCCTGCTGAGT
ATCGAAGCAGG -> TCGAAGCAGGC
ATCGAGGGGAG -> TCGAGGGGAGC
ATCGAGTGTCA -> TCGAGTGTCAG
ATCGCCCAAGC -> TCGCCCAAGCC
ATCGCCTGCGT -> TCGCCTGCGTT
ATCGCGTAATT -> TCGCGTAATTC
ATCGGAAGTAC -> TCGGAAGTACC
ATCGGAGGGCC -> TCGGAGGGCCA
ATCGGGGGGCC -> TCGGGGGGCCT
ATCGTCTGTGG -> TCGTCTGTGGG
ATCTACAATCG -> TCTACAATCGA
ATCTCCAGCGC -> TCTCCAGCGCT
ATCTGACATGT -> TCTGACATGTT
ATCTGTCCAAT -> TCTGTCCAATT
ATCTGTCGCCT -> TCTGTCGCCTG
ATCTTAATAGC -> TCTTAATAGCG
ATCTTTTTCCA -> TCTTTTTCCAG
ATGACAGCTCA -> TGACAGCTCAC
ATGACGGTTTA -> TGACGGTTTAC
ATGAGCCACGT -> TGAGCCACGTA
ATGAGCTGCCG -> TGAGCTGCCGT
ATGAGGTAAGT -> TGAGGTAAGTA
ATGATGTTCTC -> TGATGTTCTCC
ATGATTTCAAA -> TGATTTCAAAA
ATGCAAGATTT -> TGCAAGATTTC
ATGCAGAACCG -> TGCAGAACCGG
ATGCAGTCCTG -> TGCAGTCCTGC
ATGCAGTTGAC -> TGCAGTTGACA
ATGCGCCCGTA -> TGCGCCCGTAT
ATGCGCGACGA -> TGCGCGACGAA
ATGCTCCGAAC -> TGCTCCGAACG
ATGCTGCCGGC -> TGCTGCCGGCG
ATGCTTTCCGT -> TGCTTTCCGTT
ATGCTTTTCCC -> TGCTTTTCCCA
ATGGAGCGTGG -> TGGAGCGTGGA
ATGGCCCATGG -> TGGCCCATGGC
ATGGCGAACTT -> TGGCGAACTTT
ATGGGCCGGCG -> TGGGCCGGCGT
ATGGTGATATT -> TGGTGATATTG
ATGTAACCGGC -> TGTAACCGGCA
ATGTCAGACAC -> TGTCAGACACG
ATGTTAACTTC -> TGTTAACTTCC
ATGTTCTCCGT -> TGTTCTCCGTT
ATGTTGGCTCG -> TGTTGGCTCGG
ATGTTGTGTTA -> TGTTGTGTTAC
ATTACGTTTGA -> TTACGTTTGAT
ATTACTCCTCA -> TTACTCCTCAT
ATTAGCAGCCG -> TTAGCAGCCGA
ATTAGCTAAGT -> TTAGCTAAGTA
ATTAGTCCCCA -> TTAGTCCCCAA
ATTATCCAGTA -> TTATCCAGTAC
ATTCACATCGT -> TTCACATCGTC
ATTCCCAGTGC -> TTCCCAGTGCT
ATTCGGAGAGT -> TTCGGAGAGTG
ATTCGGGCCCG -> TTCGGGCCCGT
ATTCTCTTCCT -> TTCTCTTCCTT
ATTGAAGTTCC -> TTGAAGTTCCA
ATTGAGAATAT -> TTGAGAATATT
ATTGAGATCAC -> TTGAGATCACG
ATTGCCAAATG -> TTGCCAAATGA
ATTGCCTTCAC -> TTGCCTTCACC
ATTGCTGATCA -> TTGCTGATCAG
ATTGGAACTGG -> TTGGAACTGGG
ATTGGAGGGGC -> TTGGAGGGGCT
ATTGGCGACTG -> TTGGCGACTGC
ATTGGGAACAC -> TTGGGAACACC
ATTGGTCGCAT -> TTGGTCGCATC
ATTGTGATTAG -> TTGTGATTAGC
ATTTAGCGCGG -> TTTAGCGCGGT
ATTTATGCTCC -> TTTATGCTCCG
ATTTATGGAGC -> TTTATGGAGCG
ATTTCAAAATC -> TTTCAAAATCC
ATTTCATTACG -> TTTCATTACGT
ATTTCGTCGGG -> TTTCGTCGGGT
ATTTCTCCCTC -> TTTCTCCCTCA
ATTTGGCTATC -> TTTGGCTATCG
ATTTGTGAACT -> TTTGTGAACTC
ATTTTAGGAAA -> TTTTAGGAAAA
CAAAAGATGGT -> AAAAGATGGTG
CAAAAGCAATG -> AAAAGCAATGC
CAAAATCACTG -> AAAATCACTGC
CAAAATCCGCT -> AAAATCCGCTT
CAAACGCTCGG -> AAACGCTCGGG
CAAAGGGTATC -> AAAGGGTATCA
CAAAGTCCCTC -> AAAGTCCCTCC
CAAATCCCCCT -> AAATCCCCCTG
CAAATGACGGT -> AAATGACGGTT
CAAATGAGCCA -> AAATGAGCCAC
CAACAAGTTGT -> AACAAGTTGTC
CAACCGGCGCA -> AACCGGCGCAA
CAACTGCCTTC -> AACTGCCTTCA
CAAGATTTCGT -> AAGATTTCGTC
CAAGCACGGCC -> AAGCACGGCCC
CAAGCATTTGT -> AAGCATTTGTG
CAAGCCTACGC -> AAGCCTACGCG
CAAGCTGTGCT -> AAGCTGTGCTG
CAAGGGCGCTA -> AAGGGCGCTAT
CAAGGTCACGA -> AAGGTCACGAT
CAAGTACGAAA -> AAGTACGAAAA
CAAGTGATTGG -> AAGTGATTGGG
CAAGTTGTCTT -> AAGTTGTCTTT
CAATAGGCACC -> AATAGGCACCT
CAATCGAGTGT -> AATCGAGTGTC
CAATGATTTCA -> AATGATTTCAA
CAATGCGCGAC -> AATGCGCGACG
CAATGCTTTTC -> AATGCTTTTCC
CAATTATCCAG -> AATTATCCAGT
CAATTCTCTTC -> AATTCTCTTCC
CAATTGCCTTC -> AATTGCCTTCA
CAATTTCTCCC -> AATTTCTCCCT
CACAAATGACG -> ACAAATGACGG
CACACGGATTA -> ACACGGATTAG
CACACGGTCAG -> ACACGGTCAGG
CACACGTGACC -> ACACGTGACCA
CACACTTTGAG -> ACACTTTGAGG
CACAGAATTCA -> ACAGAATTCAC
CACAGGCCAGT -> ACAGGCCAGTG
CACATCGTCTG -> ACATCGTCTGT
CACCAGTCGCT -> ACCAGTCGCTC
CACCCTCAGGG -> ACCCTCAGGGG
CACCCTGGTGA -> ACCCTGGTGAG
CACCGTAAGTC -> ACCGTAAGTCA
CACCGTTCGAA -> ACCGTTCGAAA
CACCTAGTTAC -> ACCTAGTTACA
CACCTGAGACC -> ACCTGAGACCT
CACCTGAGCAA -> ACCTGAGCAAC
CACCTGGGGTA -> ACCTGGGGTAC
CACGAAATGTT -> ACGAAATGTTG
CACGAGTCCTT -> ACGAGTCCTTA
CACGATACCAA -> ACGATACCAAT
CACGATCGCGT -> ACGATCGCGTA
CACGCTCAGTT -> ACGCTCAGTTT
CACGCTCCAAA -> ACGCTCCAAAA
CACGGATTAGT -> ACGGATTAGTC
CACGGCACTTT -> ACGGCACTTTC
CACGGCCCGTC -> ACGGCCCGTCC
CACGGCTCCGG -> ACGGCTCCGGA
CACGGTCAGGA -> ACGGTCAGGAC
CACGGTCTAGG -> ACGGTCTAGGC
CACGTAAACTC -> ACGTAAACTCG
CACGTGACCAC -> ACGTGACCACC
CACTCAAACGC -> ACTCAAACGCT
CACTCAGTATC -> ACTCAGTATCC
CACTCCCGGTC -> ACTCCCGGTCT
CACTCTCGAGG -> ACTCTCGAGGG
CACTCTTAGCT -> ACTCTTAGCTA
CACTGCTCTGA -> ACTGCTCTGAT
CACTTTCCCTT -> ACTTTCCCTTT
CACTTTGAGGA -> ACTTTGAGGAT
CAGAAACAGAT -> AGAAACAGATT
CAGAAAGCTTA -> AGAAAGCTTAT
CAGAACCGGAG -> AGAACCGGAGT
CAGAATTCACA -> AGAATTCACAT
CAGACAATTTC -> AGACAATTTCT
CAGACACGCTC -> AGACACGCTCA
CAGAGCTCGAG -> AGAGCTCGAGA
CAGAGTCCAGG -> AGAGTCCAGGT
CAGATACTGTC -> AGATACTGTCC
CAGATCGGAAG -> AGATCGGAAGT
CAGATCTGACA -> AGATCTGACAT
CAGATTCGGAG -> AGATTCGGAGA
CAGATTGAGAA -> AGATTGAGAAT
CAGCAAGGGCG -> AGCAAGGGCGC
CAGCAGGACAG -> AGCAGGACAGT
CAGCCGACACG -> AGCCGACACGG
CAGCCGACCAT -> AGCCGACCATG
CAGCGCTGGCT -> AGCGCTGGCTC
CAGCTCACACG -> AGCTCACACGT
CAGCTGGTGCT -> AGCTGGTGCTG
CAGGAACTATC -> AGGAACTATCG
CAGGACAGTCC -> AGGACAGTCCC
CAGGACTTACC -> AGGACTTACCA
CAGGCACTCCC -> AGGCACTCCCG
CAGGCCAGTGG -> AGGCCAGTGGA
CAGGGATCTTA -> AGGGATCTTAA
CAGGGGTGTTA -> AGGGGTGTTAC
CAGGGTCCGAA -> AGGGTCCGAAG
CAGGTCTCACG -> AGGTCTCACGG
CAGGTGGCCTC -> AGGTGGCCTCG
CAGGTGTTCTG -> AGGTGTTCTGC
CAGTAACTGTA -> AGTAACTGTAC
CAGTACCTGAT -> AGTACCTGATA
CAGTATCCGAC -> AGTATCCGACC
CAGTCCCTGGT -> AGTCCCTGGTA
CAGTCCGCCCA -> AGTCCGCCCAA
CAGTCCTGCGC -> AGTCCTGCGCC
CAGTCGCTCCC -> AGTCGCTCCCG
CAGTCTACCGA -> AGTCTACCGAA
CAGTGCTTGGG -> AGTGCTTGGGC
CAGTGGATCTG -> AGTGGATCTGT
CAGTGGTCTGC -> AGTGGTCTGCG
CAGTTGACACG -> AGTTGACACGA
CAGTTTGTTCA -> AGTTTGTTCAA
CATAATTTATG -> ATAATTTATGG
CATACAGTCTA -> ATACAGTCTAC
CATACGGCCGA -> ATACGGCCGAT
CATCAAGGTCA -> ATCAAGGTCAC
CATCATGACAG -> ATCATGACAGC
CATCCACTCAG -> ATCCACTCAGT
CATCCGGCACT -> ATCCGGCACTC
CATCGCCCAAG -> ATCGCCCAAGC
CATCGTCTGTG -> ATCGTCTGTGG
CATCTACAATC -> ATCTACAATCG
CATCTCCAGCG -> ATCTCCAGCGC
CATCTTTTTCC -> ATCTTTTTCCA
CATGACAGCTC -> ATGACAGCTCA
CATGCAGAACC -> ATGCAGAACCG
CATGCAGTTGA -> ATGCAGTTGAC
CATGGCGAACT -> ATGGCGAACTT
CATGGGCCGGC -> ATGGGCCGGCG
CATGTTAACTT -> ATGTTAACTTC
CATGTTGGCTC -> ATGTTGGCTCG
CATTACGTTTG -> ATTACGTTTGA
CATTGAAGTTC -> ATTGAAGTTCC
CATTGCTGATC -> ATTGCTGATCA
CATTGGCGACT -> ATTGGCGACTG
CATTGGTCGCA -> ATTGGTCGCAT
CATTTGTGAAC -> ATTTGTGAACT
CCAAAATCACT -> CAAAATCACTG
CCAAAGTCCCT -> CAAAGTCCCTC
CCAAATGAGCC -> CAAATGAGCCA
CCAAGCATTTG -> CAAGCATTTGT
CCAAGCCTACG -> CAAGCCTACGC
CCAAGTGATTG -> CAAGTGATTGG
CCAATGATTTC -> CAATGATTTCA
CCAATTATCCA -> CAATTATCCAG
CCAATTCTCTT -> CAATTCTCTTC
CCACAGGCCAG -> CACAGGCCAGT
CCACCAGTCGC -> CACCAGTCGCT
CCACCCTGGTG -> CACCCTGGTGA
CCACCGTAAGT -> CACCGTAAGTC
CCACCGTTCGA -> CACCGTTCGAA
CCACGATCGCG -> CACGATCGCGT
CCACGTAAACT -> CACGTAAACTC
CCACTCAGTAT -> CACTCAGTATC
CCACTCTTAGC -> CACTCTTAGCT
CCAGAAAGCTT -> CAGAAAGCTTA
CCAGCAGGACA -> CAGCAGGACAG
CCAGCGCTGGC -> CAGCGCTGGCT
CCAGGTCTCAC -> CAGGTCTCACG
CCAGGTGTTCT -> CAGGTGTTCTG
CCAGTAACTGT -> CAGTAACTGTA
CCAGTACCTGA -> CAGTACCTGAT
CCAGTCGCTCC -> CAGTCGCTCCC
CCAGTGCTTGG -> CAGTGCTTGGG
CCAGTGGATCT -> CAGTGGATCTG
CCAGTGGTCTG -> CAGTGGTCTGC
CCATACAGTCT -> CATACAGTCTA
CCATCTCCAGC -> CATCTCCAGCG
CCATGCAGTTG -> CATGCAGTTGA
CCATGGCGAAC -> CATGGCGAACT
CCATGGGCCGG -> CATGGGCCGGC
CCATTGCTGAT -> CATTGCTGATC
CCATTGGCGAC -> CATTGGCGACT
CCCAAGCATTT -> CCAAGCATTTG
CCCAAGCCTAC -> CCAAGCCTACG
CCCAAGTGATT -> CCAAGTGATTG
CCCAATGATTT -> CCAATGATTTC
CCCACCCTGGT -> CCACCCTGGTG
CCCAGAAAGCT -> CCAGAAAGCTT
CCCAGTGCTTG -> CCAGTGCTTGG
CCCATGCAGTT -> CCATGCAGTTG
CCCATGGCGAA -> CCATGGCGAAC
CCCCAAGTGAT -> CCCAAGTGATT
CCCCAGAAAGC -> CCCAGAAAGCT
CCCCATGCAGT -> CCCATGCAGTT
CCCCCGTCGTT -> CCCCGTCGTTA
CCCCCGTGGAC -> CCCCGTGGACC
CCCCCTGAAGC -> CCCCTGAAGCG
CCCCGTCGTTA -> CCCGTCGTTAA
CCCCGTGGACC -> CCCGTGGACCG
CCCCTGAAGCG -> CCCTGAAGCGG
CCCGCTCAGAT -> CCGCTCAGATC
CCCGGTCTCCC -> CCGGTCTCCCC
CCCGTATTTTA -> CCGTATTTTAG
CCCGTCCATCT -> CCGTCCATCTC
CCCGTCGTTAA -> CCGTCGTTAAA
CCCGTGGACCG -> CCGTGGACCGT
CCCGTTGTGAG -> CCGTTGTGAGT
CCCTACAACCG -> CCTACAACCGG
CCCTAGATCCT -> CCTAGATCCTG
CCCTCAGCTGG -> CCTCAGCTGGT
CCCTCAGGGGT -> CCTCAGGGGTG
CCCTCATCTAC -> CCTCATCTACA
CCCTCCGGTCG -> CCTCCGGTCGA
CCCTGAAGCGG -> CCTGAAGCGGC
CCCTGGTATTC -> CCTGGTATTCG
CCCTGGTGAGT -> CCTGGTGAGTT
CCCTTTAGGCA -> CCTTTAGGCAG
CCGAACGATTG -> CGAACGATTGT
CCGAACTTCAC -> CGAACTTCACG
CCGAAGGGGCG -> CGAAGGGGCGA
CCGACACGGCA -> CGACACGGCAC
CCGACCATGGG -> CGACCATGGGC
CCGACCTCATC -> CGACCTCATCA
CCGAGAGGGGA -> CGAGAGGGGAG
CCGATCCCCCG -> CGATCCCCCGT
CCGATGCTGCC -> CGATGCTGCCG
CCGCATGTTAA -> CGCATGTTAAC
CCGCCCAAGCA -> CGCCCAAGCAT
CCGCTCAGATC -> CGCTCAGATCT
CCGCTTTAGAT -> CGCTTTAGATG
CCGGAGTGACC -> CGGAGTGACCC
CCGGATGAGGT -> CGGATGAGGTA
CCGGCACTCTC -> CGGCACTCTCG
CCGGCAGGAAC -> CGGCAGGAACT
CCGGCGCAAAG -> CGGCGCAAAGG
CCGGCGCCAGG -> CGGCGCCAGGT
CCGGCGTAATG -> CGGCGTAATGC
CCGGGTATCCC -> CGGGTATCCCT
CCGGTCGATCC -> CGGTCGATCCC
CCGGTCTCCCC -> CGGTCTCCCCC
CCGTAAGTCAT -> CGTAAGTCATC
CCGTAGACCAG -> CGTAGACCAGT
CCGTATTTTAG -> CGTATTTTAGG
CCGTCCATCTC -> CGTCCATCTCC
CCGTCGTTAAA -> CGTCGTTAAAT
CCGTCTCTGGC -> CGTCTCTGGCG
CCGTGGACCGT -> CGTGGACCGTA
CCGTGTCAGCC -> CGTGTCAGCCG
CCGTTAGCACA -> CGTTAGCACAG
CCGTTCCGATC -> CGTTCCGATCC
CCGTTCGAAAA -> CGTTCGAAAAG
CCGTTGTGAGT -> CGTTGTGAGTA
CCTACAACCGG -> CTACAACCGGC
CCTACGCGTTA -> CTACGCGTTAA
CCTAGATCCTG -> CTAGATCCTGC
CCTAGCGCATA -> CTAGCGCATAA
CCTAGGCACCT -> CTAGGCACCTG
CCTAGTTACAG -> CTAGTTACAGG
CCTCAGCTGGT -> CTCAGCTGGTG
CCTCAGGGGTG -> CTCAGGGGTGT
CCTCATCAAGG -> CTCATCAAGGT
CCTCATCTACA -> CTCATCTACAA
CCTCATGCAGA -> CTCATGCAGAA
CCTCCGGTCGA -> CTCCGGTCGAT
CCTCCTAGCGC -> CTCCTAGCGCA
CCTCCTTTAAA -> CTCCTTTAAAT
CCTCGCACACG -> CTCGCACACGG
CCTGAAGCGGC -> CTGAAGCGGCT
CCTGAATATCA -> CTGAATATCAG
CCTGAGACCTG -> CTGAGACCTGA
CCTGAGCAACT -> CTGAGCAACTG
CCTGATATAGA -> CTGATATAGAA
CCTGATGTCAG -> CTGATGTCAGA
CCTGCAGATTG -> CTGCAGATTGA
CCTGCGCCTCC -> CTGCGCCTCCT
CCTGCGTTCGC -> CTGCGTTCGCA
CCTGCTGAGTA -> CTGCTGAGTAA
CCTGGGGTACC -> CTGGGGTACCT
CCTGGTATTCG -> CTGGTATTCGG
CCTGGTGAGTT -> CTGGTGAGTTT
CCTGTGGAACG -> CTGTGGAACGG
CCTTAAATACG -> CTTAAATACGG
CCTTCAAATCC -> CTTCAAATCCC
CCTTCACCTAG -> CTTCACCTAGT
CCTTGATGAGC -> CTTGATGAGCT
CCTTGCCCAAT -> CTTGCCCAATG
CCTTGTAGTTT -> CTTGTAGTTTT
CCTTTAAATTG -> CTTTAAATTGG
CCTTTAGGCAG -> CTTTAGGCAGG
CGAAAAGCTCA -> GAAAAGCTCAA
CGAAAATCTGT -> GAAAATCTGTC
CGAAATGTTGT -> GAAATGTTGTG
CGAACGATTGT -> GAACGATTGTG
CGAACTTCACG -> GAACTTCACGA
CGAACTTTCTC -> GAACTTTCTCG
CGAAGACCGTG -> GAAGACCGTGT
CGAAGCAGGCA -> GAAGCAGGCAC
CGAAGGGGCGA -> GAAGGGGCGAA
CGAATATTGGA -> GAATATTGGAG
CGACACGGCAC -> GACACGGCACT
CGACCATGGGC -> GACCATGGGCC
CGACCTCATCA -> GACCTCATCAA
CGACGAAGACC -> GACGAAGACCG
CGACTGCACCT -> GACTGCACCTG
CGACTGGAGCT -> GACTGGAGCTG
CGAGAGGGGAG -> GAGAGGGGAGT
CGAGATTTATG -> GAGATTTATGC
CGAGGGCAATG -> GAGGGCAATGC
CGAGGGGAGCT -> GAGGGGAGCTT
CGAGTCCTTAA -> GAGTCCTTAAA
CGAGTGTCAGA -> GAGTGTCAGAT
CGATACCAATT -> GATACCAATTC
CGATCCCCAGA -> GATCCCCAGAA
CGATCCCCCGT -> GATCCCCCGTG
CGATCGCGTAA -> GATCGCGTAAT
CGATGCTGCCG -> GATGCTGCCGG
CGATTGTGATT -> GATTGTGATTA
CGCAAAGGGTA -> GCAAAGGGTAT
CGCACACGGTC -> GCACACGGTCA
CGCAGACAATT -> GCAGACAATTT
CGCAGGGATCT -> GCAGGGATCTT
CGCATAATTTA -> GCATAATTTAT
CGCATCCGGCA -> GCATCCGGCAC
CGCATGTTAAC -> GCATGTTAACT
CGCATTGGTCG -> GCATTGGTCGC
CGCCACCGTAA -> GCCACCGTAAG
CGCCAGGTGTT -> GCCAGGTGTTC
CGCCCAAGCAT -> GCCCAAGCATT
CGCCCAAGCCT -> GCCCAAGCCTA
CGCCCGTATTT -> GCCCGTATTTT
CGCCTCCTTTA -> GCCTCCTTTAA
CGCCTGCAGAT -> GCCTGCAGATT
CGCCTGCGTTC -> GCCTGCGTTCG
CGCGACGAAGA -> GCGACGAAGAC
CGCGCCACCGT -> GCGCCACCGTA
CGCGGCACACT -> GCGGCACACTT
CGCGGTGAGAC -> GCGGTGAGACG
CGCGTAATTCC -> GCGTAATTCCC
CGCGTTAAACT -> GCGTTAAACTT
CGCGTTCATAC -> GCGTTCATACG
CGCTAGCACAC -> GCTAGCACACG
CGCTATGTAAC -> GCTATGTAACC
CGCTCAGATCT -> GCTCAGATCTG
CGCTCAGTTTG -> GCTCAGTTTGT
CGCTCCAAAAT -> GCTCCAAAATC
CGCTCCCGCTC -> GCTCCCGCTCA
CGCTCGGGCAG -> GCTCGGGCAGA
CGCTGGCTCTC -> GCTGGCTCTCG
CGCTGGTGCTA -> GCTGGTGCTAC
CGCTTTAGATG -> GCTTTAGATGC
CGGAAGTACCT -> GGAAGTACCTG
CGGAGAGTGGT -> GGAGAGTGGTG
CGGAGGGCCAT -> GGAGGGCCATT
CGGAGTGACCC -> GGAGTGACCCC
CGGATGAGGTA -> GGATGAGGTAA
CGGATTAGTCC -> GGATTAGTCCC
CGGCACACTTT -> GGCACACTTTG
CGGCACTCTCG -> GGCACTCTCGA
CGGCACTTTCC -> GGCACTTTCCC
CGGCAGGAACT -> GGCAGGAACTA
CGGCCCGTCCA -> GGCCCGTCCAT
CGGCCGATGCT -> GGCCGATGCTG
CGGCGCAAAGG -> GGCGCAAAGGG
CGGCGCCAGGT -> GGCGCCAGGTG
CGGCGCTGGTG -> GGCGCTGGTGC
CGGCGTAATGC -> GGCGTAATGCA
CGGCTCCGGAT -> GGCTCCGGATG
CGGCTGTGCCC -> GGCTGTGCCCT
CGGCTTACTAT -> GGCTTACTATG
CGGGAATTTGG -> GGGAATTTGGC
CGGGCAGATAC -> GGGCAGATACT
CGGGCCCGTTG -> GGGCCCGTTGT
CGGGGGGCCTT -> GGGGGGCCTTG
CGGGTAGACTC -> GGGTAGACTCA
CGGGTATCCCT -> GGGTATCCCTA
CGGGTTTTCGC -> GGGTTTTCGCG
CGGTAGCTTGA -> GGTAGCTTGAT
CGGTCAAGCTG -> GGTCAAGCTGT
CGGTCAGGACT -> GGTCAGGACTT
CGGTCGATCCC -> GGTCGATCCCC
CGGTCTAGGCT -> GGTCTAGGCTC
CGGTCTCCCCC -> GGTCTCCCCCG
CGGTGAGACGT -> GGTGAGACGTA
CGGTTTACTCA -> GGTTTACTCAG
CGTAAACTCGC -> GTAAACTCGCT
CGTAAGTCATC -> GTAAGTCATCC
CGTAATGCAAG -> GTAATGCAAGA
CGTAATTCCCA -> GTAATTCCCAG
CGTACTTGATA -> GTACTTGATAA
CGTAGACCAGT -> GTAGACCAGTA
CGTATTTTAGG -> GTATTTTAGGA
CGTCACAAATG -> GTCACAAATGA
CGTCCATCTCC -> GTCCATCTCCA
CGTCGGGTAGA -> GTCGGGTAGAC
CGTCGTTAAAT -> GTCGTTAAATC
CGTCTCTGGCG -> GTCTCTGGCGG
CGTCTGTGGGG -> GTCTGTGGGGG
CGTGACCACCG -> GTGACCACCGT
CGTGCAGAGCT -> GTGCAGAGCTC
CGTGGACCGTA -> GTGGACCGTAG
CGTGGATAACA -> GTGGATAACAA
CGTGTCAGCCG -> GTGTCAGCCGA
CGTTAAACTTG -> GTTAAACTTGT
CGTTAAATCGC -> GTTAAATCGCC
CGTTAGCACAG -> GTTAGCACAGA
CGTTCATACGG -> GTTCATACGGC
CGTTCCGATCC -> GTTCCGATCCC
CGTTCGAAAAG -> GTTCGAAAAGC
CGTTCGCAGAC -> GTTCGCAGACA
CGTTGTGAGTA -> GTTGTGAGTAA
CGTTTATGGCC -> GTTTATGGCCC
CGTTTGATCGG -> GTTTGATCGGA
CTAAGTAGAAT -> TAAGTAGAATG
CTAATTTCATT -> TAATTTCATTA
CTACAACCGGC -> TACAACCGGCG
CTACAATCGAG -> TACAATCGAGT
CTACCGAACTT -> TACCGAACTTC
CTACCGGGTAT -> TACCGGGTATC
CTACCTGTGGA -> TACCTGTGGAA
CTACGCGTTAA -> TACGCGTTAAA
CTAGATCCTGC -> TAGATCCTGCT
CTAGCACACGG -> TAGCACACGGA
CTAGCGCATAA -> TAGCGCATAAT
CTAGGCACCTG -> TAGGCACCTGA
CTAGGCTCCAT -> TAGGCTCCATT
CTAGTTACAGG -> TAGTTACAGGG
CTATCGAAGCA -> TATCGAAGCAG
CTATCGAGGGG -> TATCGAGGGGA
CTATCGGGGGG -> TATCGGGGGGC
CTATGCGCCCG -> TATGCGCCCGT
CTATGTAACCG -> TATGTAACCGG
CTCAAACGCTC -> TCAAACGCTCG
CTCAACAAGTT -> TCAACAAGTTG
CTCAAGCACGG -> TCAAGCACGGC
CTCACACGTGA -> TCACACGTGAC
CTCACGGCTCC -> TCACGGCTCCG
CTCAGATCTGA -> TCAGATCTGAC
CTCAGCTGGTG -> TCAGCTGGTGC
CTCAGGGGTGT -> TCAGGGGTGTT
CTCAGTATCCG -> TCAGTATCCGA
CTCAGTCCGCC -> TCAGTCCGCCC
CTCAGTTTGTT -> TCAGTTTGTTC
CTCATCAAGGT -> TCATCAAGGTC
CTCATCATGAC -> TCATCATGACA
CTCATCTACAA -> TCATCTACAAT
CTCATGCAGAA -> TCATGCAGAAC
CTCCAAAATCA -> TCCAAAATCAC
CTCCAGCGCTG -> TCCAGCGCTGG
CTCCATTGCTG -> TCCATTGCTGA
CTCCCCCGTCG -> TCCCCCGTCGT
CTCCCGCTCAG -> TCCCGCTCAGA
CTCCCGGTCTC -> TCCCGGTCTCC
CTCCCTCATCT -> TCCCTCATCTA
CTCCGAACGAT -> TCCGAACGATT
CTCCGGATGAG -> TCCGGATGAGG
CTCCGGTCGAT -> TCCGGTCGATC
CTCCGTTAGCA -> TCCGTTAGCAC
CTCCTAGCGCA -> TCCTAGCGCAT
CTCCTCATGCA -> TCCTCATGCAG
CTCCTTTAAAT -> TCCTTTAAATT
CTCGACTGGAG -> TCGACTGGAGC
CTCGAGATTTA -> TCGAGATTTAT
CTCGAGGGCAA -> TCGAGGGCAAT
CTCGCACACGG -> TCGCACACGGT
CTCGCATTGGT -> TCGCATTGGTC
CTCGCTAGCAC -> TCGCTAGCACA
CTCGGGCAGAT -> TCGGGCAGATA
CTCGGTAGCTT -> TCGGTAGCTTG
CTCGGTCAAGC -> TCGGTCAAGCT
CTCGTCACAAA -> TCGTCACAAAT
CTCGTGCAGAG -> TCGTGCAGAGC
CTCTCGAGGGC -> TCTCGAGGGCA
CTCTCGCATTG -> TCTCGCATTGG
CTCTGATTGCC -> TCTGATTGCCA
CTCTGGCGGGT -> TCTGGCGGGTT
CTCTTAGCTAC -> TCTTAGCTACC
CTCTTCCTTGA -> TCTTCCTTGAT
CTGAAGCGGCT -> TGAAGCGGCTG
CTGAATATCAG -> TGAATATCAGC
CTGACATGTTG -> TGACATGTTGG
CTGAGACCTGA -> TGAGACCTGAA
CTGAGCAACTG -> TGAGCAACTGC
CTGAGTAACCG -> TGAGTAACCGC
CTGATATAGAA -> TGATATAGAAA
CTGATCAGAGT -> TGATCAGAGTC
CTGATGTCAGA -> TGATGTCAGAC
CTGATTGCCAA -> TGATTGCCAAA
CTGCAAAAGCA -> TGCAAAAGCAA
CTGCACCTGGG -> TGCACCTGGGG
CTGCAGATTGA -> TGCAGATTGAG
CTGCCGGCGCC -> TGCCGGCGCCA
CTGCCGTCTCT -> TGCCGTCTCTG
CTGCCTTCAAA -> TGCCTTCAAAT
CTGCCTTGTAG -> TGCCTTGTAGT
CTGCGCCTCCT -> TGCGCCTCCTT
CTGCGTTCGCA -> TGCGTTCGCAG
CTGCGTTTATG -> TGCGTTTATGG
CTGCTCGACTG -> TGCTCGACTGG
CTGCTCTGATT -> TGCTCTGATTG
CTGCTGAGTAA -> TGCTGAGTAAC
CTGGAGCTGCC -> TGGAGCTGCCT
CTGGCGGGTTT -> TGGCGGGTTTT
CTGGCTCTCGC -> TGGCTCTCGCA
CTGGGATAACC -> TGGGATAACCA
CTGGGCTCGTG -> TGGGCTCGTGC
CTGGGGTACCT -> TGGGGTACCTC
CTGGTATTCGG -> TGGTATTCGGG
CTGGTGAGTTT -> TGGTGAGTTTC
CTGGTGCTACC -> TGGTGCTACCT
CTGGTGCTGGG -> TGGTGCTGGGA
CTGTACCCTAG -> TGTACCCTAGA
CTGTCCAATTA -> TGTCCAATTAT
CTGTCCACAGG -> TGTCCACAGGC
CTGTCGCCTGC -> TGTCGCCTGCA
CTGTGCCCTCA -> TGTGCCCTCAG
CTGTGCTGCAA -> TGTGCTGCAAA
CTGTGGAACGG -> TGTGGAACGGC
CTGTGGGGGCG -> TGTGGGGGCGC
CTTAAATACGG -> TTAAATACGGG
CTTAATAGCGC -> TTAATAGCGCG
CTTACCATACA -> TTACCATACAG
CTTACTATGCG -> TTACTATGCGC
CTTAGCTACCG -> TTAGCTACCGG
CTTATTAGCTA -> TTATTAGCTAA
CTTCAAATCCC -> TTCAAATCCCC
CTTCACCTAGT -> TTCACCTAGTT
CTTCACGAAAT -> TTCACGAAATG
CTTCATCTTTT -> TTCATCTTTTT
CTTCCACCAGT -> TTCCACCAGTC
CTTCCTAGGCA -> TTCCTAGGCAC
CTTCCTTGATG -> TTCCTTGATGA
CTTGATAAGCA -> TTGATAAGCAC
CTTGATACTCA -> TTGATACTCAT
CTTGATGAGCT -> TTGATGAGCTG
CTTGCCCAATG -> TTGCCCAATGA
CTTGGGCAAGT -> TTGGGCAAGTA
CTTGTAGTTTT -> TTGTAGTTTTA
CTTGTGCCAGT -> TTGTGCCAGTG
CTTTAAATTGG -> TTTAAATTGGA
CTTTACTTCAT -> TTTACTTCATC
CTTTAGATGCT -> TTTAGATGCTT
CTTTAGGCAGG -> TTTAGGCAGGT
CTTTCCCTTTA -> TTTCCCTTTAG
CTTTCCGTTCC -> TTTCCGTTCCG
CTTTCTCGTCA -> TTTCTCGTCAC
CTTTGAGGATG -> TTTGAGGATGA
CTTTTCCCACC -> TTTTCCCACCC
CTTTTTCCAGC -> TTTTTCCAGCA
GAAAACACTCA -> AAAACACTCAA
GAAAAGCTCAA -> AAAAGCTCAAC
GAAAATCTGTC -> AAAATCTGTCC
GAAACAGAAAC -> AAACAGAAACA
GAAACAGATTC -> AAACAGATTCG
GAAAGCTTATT -> AAAGCTTATTA
GAAATGTTGTG -> AAATGTTGTGT
GAACACCCTCA -> AACACCCTCAG
GAACCGGAGTG -> AACCGGAGTGA
GAACGATTGTG -> AACGATTGTGA
GAACGGCTTAC -> AACGGCTTACT
GAACTATCGAG -> AACTATCGAGG
GAACTCGGTCA -> AACTCGGTCAA
GAACTGGGCTC -> AACTGGGCTCG
GAACTTCACGA -> AACTTCACGAA
GAACTTTCTCG -> AACTTTCTCGT
GAAGACCGTGT -> AAGACCGTGTC
GAAGCAGGCAC -> AAGCAGGCACT
GAAGCGGCTGT -> AAGCGGCTGTG
GAAGGGGCGAA -> AAGGGGCGAAT
GAAGTACCTGA -> AAGTACCTGAT
GAAGTTCCACG -> AAGTTCCACGA
GAATATCAGCA -> AATATCAGCAA
GAATATTACTC -> AATATTACTCC
GAATATTGGAG -> AATATTGGAGG
GAATGCAGTCC -> AATGCAGTCCT
GAATTCACATC -> AATTCACATCG
GAATTTGGCTA -> AATTTGGCTAT
GACAATTTCTC -> ACAATTTCTCC
GACACGAGTCC -> ACACGAGTCCT
GACACGCTCAG -> ACACGCTCAGT
GACACGGCACT -> ACACGGCACTT
GACAGCTCACA -> ACAGCTCACAC
GACAGTCCCTG -> ACAGTCCCTGG
GACATGTTGGC -> ACATGTTGGCT
GACCACCGTTC -> ACCACCGTTCG
GACCAGTAACT -> ACCAGTAACTG
GACCATGGGCC -> ACCATGGGCCG
GACCCCATGCA -> ACCCCATGCAG
GACCGTAGACC -> ACCGTAGACCA
GACCGTGTCAG -> ACCGTGTCAGC
GACCTCATCAA -> ACCTCATCAAG
GACCTGAATAT -> ACCTGAATATC
GACGAAGACCG -> ACGAAGACCGT
GACGGTTTACT -> ACGGTTTACTC
GACGTACTTGA -> ACGTACTTGAT
GACTCAAGCAC -> ACTCAAGCACG
GACTGCACCTG -> ACTGCACCTGG
GACTGGAGCTG -> ACTGGAGCTGC
GACTTACCATA -> ACTTACCATAC
GAGAATATTAC -> AGAATATTACT
GAGACCTGAAT -> AGACCTGAATA
GAGACGTACTT -> AGACGTACTTG
GAGAGGGGAGT -> AGAGGGGAGTC
GAGAGTGGTGC -> AGAGTGGTGCA
GAGATCACGGT -> AGATCACGGTC
GAGATTTATGC -> AGATTTATGCT
GAGCAACTGCC -> AGCAACTGCCT
GAGCAATTGCC -> AGCAATTGCCT
GAGCCACGTAA -> AGCCACGTAAA
GAGCGTGGATA -> AGCGTGGATAA
GAGCTCGAGAT -> AGCTCGAGATT
GAGCTGCCGTC -> AGCTGCCGTCT
GAGCTGCCTTG -> AGCTGCCTTGT
GAGCTTCCACC -> AGCTTCCACCA
GAGGATGATGT -> AGGATGATGTT
GAGGGCAATGC -> AGGGCAATGCG
GAGGGCCATTG -> AGGGCCATTGG
GAGGGGAGCTT -> AGGGGAGCTTC
GAGGGGAGTCG -> AGGGGAGTCGC
GAGGGGCTATC -> AGGGGCTATCG
GAGGTAAGTAC -> AGGTAAGTACC
GAGTAAAATTT -> AGTAAAATTTA
GAGTAACCGCA -> AGTAACCGCAT
GAGTCCAGGTC -> AGTCCAGGTCT
GAGTCCTTAAA -> AGTCCTTAAAT
GAGTCGCGGCA -> AGTCGCGGCAC
GAGTGACCCCA -> AGTGACCCCAT
GAGTGGTGCAT -> AGTGGTGCATC
GAGTGTCAGAT -> AGTGTCAGATC
GAGTTTCCGAG -> AGTTTCCGAGA
GATAACAAAAG -> ATAACAAAAGA
GATAACCAAAG -> ATAACCAAAGT
GATAAGCACGC -> ATAAGCACGCT
GATACCAATTC -> ATACCAATTCT
GATACTCATCA -> ATACTCATCAT
GATACTGTCCA -> ATACTGTCCAC
GATATAGAAAC -> ATATAGAAACA
GATATTGAGAT -> ATATTGAGATC
GATCACGGTCT -> ATCACGGTCTA
GATCAGAGTCC -> ATCAGAGTCCA
GATCCCCAGAA -> ATCCCCAGAAA
GATCCCCCGTG -> ATCCCCCGTGG
GATCCTGCTGA -> ATCCTGCTGAG
GATCGCGTAAT -> ATCGCGTAATT
GATCGGAAGTA -> ATCGGAAGTAC
GATCGGAGGGC -> ATCGGAGGGCC
GATCTGACATG -> ATCTGACATGT
GATCTGTCGCC -> ATCTGTCGCCT
GATCTTAATAG -> ATCTTAATAGC
GATGAGCTGCC -> ATGAGCTGCCG
GATGAGGTAAG -> ATGAGGTAAGT
GATGATGTTCT -> ATGATGTTCTC
GATGCTGCCGG -> ATGCTGCCGGC
GATGCTTTCCG -> ATGCTTTCCGT
GATGGTGATAT -> ATGGTGATATT
GATGTCAGACA -> ATGTCAGACAC
GATGTTCTCCG -> ATGTTCTCCGT
GATTAGCAGCC -> ATTAGCAGCCG
GATTAGTCCCC -> ATTAGTCCCCA
GATTCGGAGAG -> ATTCGGAGAGT
GATTGAGAATA -> ATTGAGAATAT
GATTGCCAAAT -> ATTGCCAAATG
GATTGGGAACA -> ATTGGGAACAC
GATTGTGATTA -> ATTGTGATTAG
GATTTATGCTC -> ATTTATGCTCC
GATTTCAAAAT -> ATTTCAAAATC
GATTTCGTCGG -> ATTTCGTCGGG
GCAAAAGCAAT -> CAAAAGCAATG
GCAAAGGGTAT -> CAAAGGGTATC
GCAACTGCCTT -> CAACTGCCTTC
GCAAGATTTCG -> CAAGATTTCGT
GCAAGGGCGCT -> CAAGGGCGCTA
GCAAGTACGAA -> CAAGTACGAAA
GCAATGCGCGA -> CAATGCGCGAC
GCAATGCTTTT -> CAATGCTTTTC
GCAATTGCCTT -> CAATTGCCTTC
GCACACGGATT -> CACACGGATTA
GCACACGGTCA -> CACACGGTCAG
GCACACTTTGA -> CACACTTTGAG
GCACAGAATTC -> CACAGAATTCA
GCACCTGAGAC -> CACCTGAGACC
GCACCTGAGCA -> CACCTGAGCAA
GCACCTGGGGT -> CACCTGGGGTA
GCACGCTCCAA -> CACGCTCCAAA
GCACGGCCCGT -> CACGGCCCGTC
GCACTCCCGGT -> CACTCCCGGTC
GCACTCTCGAG -> CACTCTCGAGG
GCACTTTCCCT -> CACTTTCCCTT
GCAGAACCGGA -> CAGAACCGGAG
GCAGACAATTT -> CAGACAATTTC
GCAGAGCTCGA -> CAGAGCTCGAG
GCAGATACTGT -> CAGATACTGTC
GCAGATTGAGA -> CAGATTGAGAA
GCAGCCGACCA -> CAGCCGACCAT
GCAGGAACTAT -> CAGGAACTATC
GCAGGACAGTC -> CAGGACAGTCC
GCAGGCACTCC -> CAGGCACTCCC
GCAGGGATCTT -> CAGGGATCTTA
GCAGGTGGCCT -> CAGGTGGCCTC
GCAGTCCTGCG -> CAGTCCTGCGC
GCAGTTGACAC -> CAGTTGACACG
GCATAATTTAT -> CATAATTTATG
GCATCCGGCAC -> CATCCGGCACT
GCATCGCCCAA -> CATCGCCCAAG
GCATGTTAACT -> CATGTTAACTT
GCATTGGTCGC -> CATTGGTCGCA
GCATTTGTGAA -> CATTTGTGAAC
GCCAAATGAGC -> CCAAATGAGCC
GCCACCGTAAG -> CCACCGTAAGT
GCCACGTAAAC -> CCACGTAAACT
GCCAGGTGTTC -> CCAGGTGTTCT
GCCAGTGGATC -> CCAGTGGATCT
GCCAGTGGTCT -> CCAGTGGTCTG
GCCATTGGCGA -> CCATTGGCGAC
GCCCAAGCATT -> CCCAAGCATTT
GCCCAAGCCTA -> CCCAAGCCTAC
GCCCAATGATT -> CCCAATGATTT
GCCCATGGCGA -> CCCATGGCGAA
GCCCGTATTTT -> CCCGTATTTTA
GCCCGTCCATC -> CCCGTCCATCT
GCCCGTTGTGA -> CCCGTTGTGAG
GCCCTCAGCTG -> CCCTCAGCTGG
GCCGACACGGC -> CCGACACGGCA
GCCGACCATGG -> CCGACCATGGG
GCCGATGCTGC -> CCGATGCTGCC
GCCGGCGCCAG -> CCGGCGCCAGG
GCCGGCGTAAT -> CCGGCGTAATG
GCCGTCTCTGG -> CCGTCTCTGGC
GCCTACGCGTT -> CCTACGCGTTA
GCCTCCTTTAA -> CCTCCTTTAAA
GCCTCGCACAC -> CCTCGCACACG
GCCTGCAGATT -> CCTGCAGATTG
GCCTGCGTTCG -> CCTGCGTTCGC
GCCTTCAAATC -> CCTTCAAATCC
GCCTTCACCTA -> CCTTCACCTAG
GCCTTGCCCAA -> CCTTGCCCAAT
GCCTTGTAGTT -> CCTTGTAGTTT
GCGAACTTTCT -> CGAACTTTCTC
GCGAATATTGG -> CGAATATTGGA
GCGACGAAGAC -> CGACGAAGACC
GCGACTGCACC -> CGACTGCACCT
GCGCAAAGGGT -> CGCAAAGGGTA
GCGCAGGGATC -> CGCAGGGATCT
GCGCATAATTT -> CGCATAATTTA
GCGCCACCGTA -> CGCCACCGTAA
GCGCCAGGTGT -> CGCCAGGTGTT
GCGCCCGTATT -> CGCCCGTATTT
GCGCCTCCTTT -> CGCCTCCTTTA
GCGCGACGAAG -> CGCGACGAAGA
GCGCGCCACCG -> CGCGCCACCGT
GCGCGGTGAGA -> CGCGGTGAGAC
GCGCTATGTAA -> CGCTATGTAAC
GCGCTGGCTCT -> CGCTGGCTCTC
GCGCTGGTGCT -> CGCTGGTGCTA
GCGGCACACTT -> CGGCACACTTT
GCGGCTGTGCC -> CGGCTGTGCCC
GCGGGTTTTCG -> CGGGTTTTCGC
GCGGTGAGACG -> CGGTGAGACGT
GCGTAATGCAA -> CGTAATGCAAG
GCGTAATTCCC -> CGTAATTCCCA
GCGTGGATAAC -> CGTGGATAACA
GCGTTAAACTT -> CGTTAAACTTG
GCGTTCATACG -> CGTTCATACGG
GCGTTCGCAGA -> CGTTCGCAGAC
GCGTTTATGGC -> CGTTTATGGCC
GCTAAGTAGAA -> CTAAGTAGAAT
GCTACCGGGTA -> CTACCGGGTAT
GCTACCTGTGG -> CTACCTGTGGA
GCTAGCACACG -> CTAGCACACGG
GCTATCGAAGC -> CTATCGAAGCA
GCTATCGGGGG -> CTATCGGGGGG
GCTATGTAACC -> CTATGTAACCG
GCTCAACAAGT -> CTCAACAAGTT
GCTCACACGTG -> CTCACACGTGA
GCTCAGATCTG -> CTCAGATCTGA
GCTCAGTTTGT -> CTCAGTTTGTT
GCTCCAAAATC -> CTCCAAAATCA
GCTCCATTGCT -> CTCCATTGCTG
GCTCCCGCTCA -> CTCCCGCTCAG
GCTCCGAACGA -> CTCCGAACGAT
GCTCCGGATGA -> CTCCGGATGAG
GCTCGACTGGA -> CTCGACTGGAG
GCTCGAGATTT -> CTCGAGATTTA
GCTCGGGCAGA -> CTCGGGCAGAT
GCTCGGTAGCT -> CTCGGTAGCTT
GCTCGTGCAGA -> CTCGTGCAGAG
GCTCTCGCATT -> CTCTCGCATTG
GCTCTGATTGC -> CTCTGATTGCC
GCTGAGTAACC -> CTGAGTAACCG
GCTGATCAGAG -> CTGATCAGAGT
GCTGCAAAAGC -> CTGCAAAAGCA
GCTGCCGGCGC -> CTGCCGGCGCC
GCTGCCGTCTC -> CTGCCGTCTCT
GCTGCCTTGTA -> CTGCCTTGTAG
GCTGGCTCTCG -> CTGGCTCTCGC
GCTGGGATAAC -> CTGGGATAACC
GCTGGTGCTAC -> CTGGTGCTACC
GCTGGTGCTGG -> CTGGTGCTGGG
GCTGTGCCCTC -> CTGTGCCCTCA
GCTGTGCTGCA -> CTGTGCTGCAA
GCTTACTATGC -> CTTACTATGCG
GCTTATTAGCT -> CTTATTAGCTA
GCTTCCACCAG -> CTTCCACCAGT
GCTTGATACTC -> CTTGATACTCA
GCTTGGGCAAG -> CTTGGGCAAGT
GCTTTAGATGC -> CTTTAGATGCT
GCTTTCCGTTC -> CTTTCCGTTCC
GCTTTTCCCAC -> CTTTTCCCACC
GGAAAACACTC -> GAAAACACTCA
GGAACACCCTC -> GAACACCCTCA
GGAACGGCTTA -> GAACGGCTTAC
GGAACTATCGA -> GAACTATCGAG
GGAACTGGGCT -> GAACTGGGCTC
GGAAGTACCTG -> GAAGTACCTGA
GGAATTTGGCT -> GAATTTGGCTA
GGACAGTCCCT -> GACAGTCCCTG
GGACCGTAGAC -> GACCGTAGACC
GGACTTACCAT -> GACTTACCATA
GGAGAGTGGTG -> GAGAGTGGTGC
GGAGCGTGGAT -> GAGCGTGGATA
GGAGCTGCCTT -> GAGCTGCCTTG
GGAGCTTCCAC -> GAGCTTCCACC
GGAGGGCCATT -> GAGGGCCATTG
GGAGGGGCTAT -> GAGGGGCTATC
GGAGTCGCGGC -> GAGTCGCGGCA
GGAGTGACCCC -> GAGTGACCCCA
GGATAACAAAA -> GATAACAAAAG
GGATAACCAAA -> GATAACCAAAG
GGATCTGTCGC -> GATCTGTCGCC
GGATCTTAATA -> GATCTTAATAG
GGATGAGGTAA -> GATGAGGTAAG
GGATGATGTTC -> GATGATGTTCT
GGATTAGTCCC -> GATTAGTCCCC
GGCAAGTACGA -> GCAAGTACGAA
GGCAATGCGCG -> GCAATGCGCGA
GGCACACTTTG -> GCACACTTTGA
GGCACCTGAGA -> GCACCTGAGAC
GGCACCTGAGC -> GCACCTGAGCA
GGCACTCCCGG -> GCACTCCCGGT
GGCACTCTCGA -> GCACTCTCGAG
GGCACTTTCCC -> GCACTTTCCCT
GGCAGATACTG -> GCAGATACTGT
GGCAGGAACTA -> GCAGGAACTAT
GGCAGGTGGCC -> GCAGGTGGCCT
GGCCAGTGGAT -> GCCAGTGGATC
GGCCATTGGCG -> GCCATTGGCGA
GGCCCATGGCG -> GCCCATGGCGA
GGCCCGTCCAT -> GCCCGTCCATC
GGCCCGTTGTG -> GCCCGTTGTGA
GGCCGATGCTG -> GCCGATGCTGC
GGCCGGCGTAA -> GCCGGCGTAAT
GGCCTCGCACA -> GCCTCGCACAC
GGCCTTGCCCA -> GCCTTGCCCAA
GGCGAACTTTC -> GCGAACTTTCT
GGCGAATATTG -> GCGAATATTGG
GGCGACTGCAC -> GCGACTGCACC
GGCGCAAAGGG -> GCGCAAAGGGT
GGCGCAGGGAT -> GCGCAGGGATC
GGCGCCAGGTG -> GCGCCAGGTGT
GGCGCTATGTA -> GCGCTATGTAA
GGCGCTGGTGC -> GCGCTGGTGCT
GGCGGGTTTTC -> GCGGGTTTTCG
GGCGTAATGCA -> GCGTAATGCAA
GGCTATCGAAG -> GCTATCGAAGC
GGCTATCGGGG -> GCTATCGGGGG
GGCTCCATTGC -> GCTCCATTGCT
GGCTCCGGATG -> GCTCCGGATGA
GGCTCGGTAGC -> GCTCGGTAGCT
GGCTCGTGCAG -> GCTCGTGCAGA
GGCTCTCGCAT -> GCTCTCGCATT
GGCTGTGCCCT -> GCTGTGCCCTC
GGCTTACTATG -> GCTTACTATGC
GGGAACACCCT -> GGAACACCCTC
GGGAATTTGGC -> GGAATTTGGCT
GGGAGCTTCCA -> GGAGCTTCCAC
GGGAGTCGCGG -> GGAGTCGCGGC
GGGATAACCAA -> GGATAACCAAA
GGGATCTTAAT -> GGATCTTAATA
GGGCAAGTACG -> GGCAAGTACGA
GGGCAATGCGC -> GGCAATGCGCG
GGGCAGATACT -> GGCAGATACTG
GGGCCATTGGC -> GGCCATTGGCG
GGGCCCGTTGT -> GGCCCGTTGTG
GGGCCGGCGTA -> GGCCGGCGTAA
GGGCCTTGCCC -> GGCCTTGCCCA
GGGCGAATATT -> GGCGAATATTG
GGGCGCAGGGA -> GGCGCAGGGAT
GGGCGCTATGT -> GGCGCTATGTA
GGGCTATCGAA -> GGCTATCGAAG
GGGCTCGTGCA -> GGCTCGTGCAG
GGGGAGCTTCC -> GGGAGCTTCCA
GGGGAGTCGCG -> GGGAGTCGCGG
GGGGCCTTGCC -> GGGCCTTGCCC
GGGGCGAATAT -> GGGCGAATATT
GGGGCGCAGGG -> GGGCGCAGGGA
GGGGCTATCGA -> GGGCTATCGAA
GGGGGCCTTGC -> GGGGCCTTGCC
GGGGGCGCAGG -> GGGGCGCAGGG
GGGGGGCCTTG -> GGGGGCCTTGC
GGGGTACCTCC -> GGGTACCTCCT
GGGGTGTTACT -> GGGTGTTACTA
GGGTACCTCCT -> GGTACCTCCTA
GGGTAGACTCA -> GGTAGACTCAA
GGGTATCATTG -> GGTATCATTGA
GGGTATCCCTA -> GGTATCCCTAC
GGGTCCGAAGG -> GGTCCGAAGGG
GGGTGTTACTA -> GGTGTTACTAA
GGGTTTTCGCG -> GGTTTTCGCGT
GGTAAGTACCA -> GTAAGTACCAC
GGTACCTCCTA -> GTACCTCCTAG
GGTAGACTCAA -> GTAGACTCAAG
GGTAGCTTGAT -> GTAGCTTGATA
GGTATCATTGA -> GTATCATTGAA
GGTATCCCTAC -> GTATCCCTACA
GGTATTCGGGC -> GTATTCGGGCC
GGTCAAGCTGT -> GTCAAGCTGTG
GGTCACGATAC -> GTCACGATACC
GGTCAGGACTT -> GTCAGGACTTA
GGTCCGAAGGG -> GTCCGAAGGGG
GGTCGATCCCC -> GTCGATCCCCA
GGTCGCATCCG -> GTCGCATCCGG
GGTCTAGGCTC -> GTCTAGGCTCC
GGTCTCACGGC -> GTCTCACGGCT
GGTCTCCCCCG -> GTCTCCCCCGT
GGTCTGCGTTT -> GTCTGCGTTTA
GGTGAGACGTA -> GTGAGACGTAC
GGTGAGTTTCC -> GTGAGTTTCCG
GGTGATATTGA -> GTGATATTGAG
GGTGCATCGCC -> GTGCATCGCCC
GGTGCTACCTG -> GTGCTACCTGT
GGTGCTGGGAT -> GTGCTGGGATA
GGTGGCCTCGC -> GTGGCCTCGCA
GGTGTTACTAA -> GTGTTACTAAT
GGTGTTCTGCT -> GTGTTCTGCTC
GGTTTACTCAG -> GTTTACTCAGT
GGTTTTCGCGT -> GTTTTCGCGTT
GTAAAATTTAG -> TAAAATTTAGC
GTAAACTCGCT -> TAAACTCGCTA
GTAACCGCATG -> TAACCGCATGT
GTAACCGGCAG -> TAACCGGCAGG
GTAACTGTACC -> TAACTGTACCC
GTAAGTACCAC -> TAAGTACCACT
GTAAGTCATCC -> TAAGTCATCCA
GTAATGCAAGA -> TAATGCAAGAT
GTAATTCCCAG -> TAATTCCCAGT
GTACCACTCTT -> TACCACTCTTA
GTACCCTAGAT -> TACCCTAGATC
GTACCTCCTAG -> TACCTCCTAGC
GTACCTGATAT -> TACCTGATATA
GTACCTGATGT -> TACCTGATGTC
GTACGAAAATC -> TACGAAAATCT
GTACTTGATAA -> TACTTGATAAG
GTAGAATGCAG -> TAGAATGCAGT
GTAGACCAGTA -> TAGACCAGTAA
GTAGACTCAAG -> TAGACTCAAGC
GTAGCTTGATA -> TAGCTTGATAC
GTAGTTTTAGA -> TAGTTTTAGAG
GTATCATTGAA -> TATCATTGAAG
GTATCCCTACA -> TATCCCTACAA
GTATCCGACCT -> TATCCGACCTC
GTATTCGGGCC -> TATTCGGGCCC
GTATTTTAGGA -> TATTTTAGGAA
GTCAAGCTGTG -> TCAAGCTGTGC
GTCACAAATGA -> TCACAAATGAC
GTCACGATACC -> TCACGATACCA
GTCAGACACGC -> TCAGACACGCT
GTCAGATCGGA -> TCAGATCGGAA
GTCAGCCGACA -> TCAGCCGACAC
GTCAGGACTTA -> TCAGGACTTAC
GTCATCCACTC -> TCATCCACTCA
GTCCAATTATC -> TCCAATTATCC
GTCCACAGGCC -> TCCACAGGCCA
GTCCAGGTCTC -> TCCAGGTCTCA
GTCCATCTCCA -> TCCATCTCCAG
GTCCCCAAGTG -> TCCCCAAGTGA
GTCCCTCCGGT -> TCCCTCCGGTC
GTCCCTGGTAT -> TCCCTGGTATT
GTCCGAAGGGG -> TCCGAAGGGGC
GTCCGCCCAAG -> TCCGCCCAAGC
GTCCTGCGCCT -> TCCTGCGCCTC
GTCCTTAAATA -> TCCTTAAATAC
GTCGATCCCCA -> TCGATCCCCAG
GTCGCATCCGG -> TCGCATCCGGC
GTCGCCTGCAG -> TCGCCTGCAGA
GTCGCGGCACA -> TCGCGGCACAC
GTCGCTCCCGC -> TCGCTCCCGCT
GTCGGGTAGAC -> TCGGGTAGACT
GTCGTTAAATC -> TCGTTAAATCG
GTCTACCGAAC -> TCTACCGAACT
GTCTAGGCTCC -> TCTAGGCTCCA
GTCTCACGGCT -> TCTCACGGCTC
GTCTCCCCCGT -> TCTCCCCCGTC
GTCTCTGGCGG -> TCTCTGGCGGG
GTCTGCGTTTA -> TCTGCGTTTAT
GTCTGTGGGGG -> TCTGTGGGGGC
GTCTTTACTTC -> TCTTTACTTCA
GTGAACTCGGT -> TGAACTCGGTC
GTGACCACCGT -> TGACCACCGTT
GTGACCCCATG -> TGACCCCATGC
GTGAGACGTAC -> TGAGACGTACT
GTGAGTAAAAT -> TGAGTAAAATT
GTGAGTTTCCG -> TGAGTTTCCGA
GTGATATTGAG -> TGATATTGAGA
GTGATTAGCAG -> TGATTAGCAGC
GTGATTGGGAA -> TGATTGGGAAC
GTGCAGAGCTC -> TGCAGAGCTCG
GTGCATCGCCC -> TGCATCGCCCA
GTGCCAGTGGT -> TGCCAGTGGTC
GTGCCCTCAGC -> TGCCCTCAGCT
GTGCTACCTGT -> TGCTACCTGTG
GTGCTGCAAAA -> TGCTGCAAAAG
GTGCTGGGATA -> TGCTGGGATAA
GTGCTTGGGCA -> TGCTTGGGCAA
GTGGAACGGCT -> TGGAACGGCTT
GTGGACCGTAG -> TGGACCGTAGA
GTGGATAACAA -> TGGATAACAAA
GTGGATCTGTC -> TGGATCTGTCG
GTGGCCTCGCA -> TGGCCTCGCAC
GTGGGGGCGCA -> TGGGGGCGCAG
GTGGTCTGCGT -> TGGTCTGCGTT
GTGGTGCATCG -> TGGTGCATCGC
GTGTCAGATCG -> TGTCAGATCGG
GTGTCAGCCGA -> TGTCAGCCGAC
GTGTTACTAAT -> TGTTACTAATT
GTGTTCTGCTC -> TGTTCTGCTCG
GTTAAACTTGT -> TTAAACTTGTG
GTTAAATCGCC -> TTAAATCGCCT
GTTAACTTCCT -> TTAACTTCCTA
GTTACAGGGTC -> TTACAGGGTCC
GTTACTAATTT -> TTACTAATTTC
GTTAGCACAGA -> TTAGCACAGAA
GTTCAATAGGC -> TTCAATAGGCA
GTTCATACGGC -> TTCATACGGCC
GTTCCACGATC -> TTCCACGATCG
GTTCCGATCCC -> TTCCGATCCCC
GTTCGAAAAGC -> TTCGAAAAGCT
GTTCGCAGACA -> TTCGCAGACAA
GTTCTCCGTTA -> TTCTCCGTTAG
GTTCTGCTCGA -> TTCTGCTCGAC
GTTGACACGAG -> TTGACACGAGT
GTTGGCTCGGT -> TTGGCTCGGTA
GTTGTCTTTAC -> TTGTCTTTACT
GTTGTGAGTAA -> TTGTGAGTAAA
GTTTACTCAGT -> TTTACTCAGTC
GTTTATGGCCC -> TTTATGGCCCA
GTTTCCGAGAG -> TTTCCGAGAGG
GTTTGATCGGA -> TTTGATCGGAG
GTTTGTTCAAT -> TTTGTTCAATA
GTTTTAGAGCA -> TTTTAGAGCAA
GTTTTCGCGTT -> TTTTCGCGTTC
TAAAATTTAGC -> AAAATTTAGCG
TAAACTCGCTA -> AAACTCGCTAG
TAAACTTGTGC -> AAACTTGTGCC
TAAATACGGGA -> AAATACGGGAA
TAAATCGCCTG -> AAATCGCCTGC
TAAATTGGAAC -> AAATTGGAACT
TAACAAAAGAT -> AACAAAAGATG
TAACCAAAGTC -> AACCAAAGTCC
TAACCGCATGT -> AACCGCATGTT
TAACCGGCAGG -> AACCGGCAGGA
TAACTGTACCC -> AACTGTACCCT
TAACTTCCTAG -> AACTTCCTAGG
TAAGCACGCTC -> AAGCACGCTCC
TAAGTACCACT -> AAGTACCACTC
TAAGTAGAATG -> AAGTAGAATGC
TAAGTCATCCA -> AAGTCATCCAC
TAATAGCGCGC -> AATAGCGCGCC
TAATGCAAGAT -> AATGCAAGATT
TAATTCCCAGT -> AATTCCCAGTG
TAATTTATGGA -> AATTTATGGAG
TAATTTCATTA -> AATTTCATTAC
TACAACCGGCG -> ACAACCGGCGC
TACAATCGAGT -> ACAATCGAGTG
TACAGGGTCCG -> ACAGGGTCCGA
TACAGTCTACC -> ACAGTCTACCG
TACCAATTCTC -> ACCAATTCTCT
TACCACTCTTA -> ACCACTCTTAG
TACCATACAGT -> ACCATACAGTC
TACCCTAGATC -> ACCCTAGATCC
TACCGAACTTC -> ACCGAACTTCA
TACCGGGTATC -> ACCGGGTATCC
TACCTCCTAGC -> ACCTCCTAGCG
TACCTGATATA -> ACCTGATATAG
TACCTGATGTC -> ACCTGATGTCA
TACCTGTGGAA -> ACCTGTGGAAC
TACGAAAATCT -> ACGAAAATCTG
TACGCGTTAAA -> ACGCGTTAAAC
TACGGCCGATG -> ACGGCCGATGC
TACGGGAATTT -> ACGGGAATTTG
TACGTTTGATC -> ACGTTTGATCG
TACTAATTTCA -> ACTAATTTCAT
TACTATGCGCC -> ACTATGCGCCC
TACTCAGTCCG -> ACTCAGTCCGC
TACTCATCATG -> ACTCATCATGA
TACTCCTCATG -> ACTCCTCATGC
TACTGTCCACA -> ACTGTCCACAG
TACTTCATCTT -> ACTTCATCTTT
TACTTGATAAG -> ACTTGATAAGC
TAGAAACAGAA -> AGAAACAGAAA
TAGAATGCAGT -> AGAATGCAGTC
TAGACCAGTAA -> AGACCAGTAAC
TAGACTCAAGC -> AGACTCAAGCA
TAGAGCAATTG -> AGAGCAATTGC
TAGATCCTGCT -> AGATCCTGCTG
TAGATGCTTTC -> AGATGCTTTCC
TAGCACACGGA -> AGCACACGGAT
TAGCACAGAAT -> AGCACAGAATT
TAGCAGCCGAC -> AGCAGCCGACC
TAGCGCATAAT -> AGCGCATAATT
TAGCGCGCCAC -> AGCGCGCCACC
TAGCGCGGTGA -> AGCGCGGTGAG
TAGCTAAGTAG -> AGCTAAGTAGA
TAGCTACCGGG -> AGCTACCGGGT
TAGCTTGATAC -> AGCTTGATACT
TAGGAAAACAC -> AGGAAAACACT
TAGGCACCTGA -> AGGCACCTGAG,AGGCACCTGAG
TAGGCAGGTGG -> AGGCAGGTGGC
TAGGCTCCATT -> AGGCTCCATTG
TAGTCCCCAAG -> AGTCCCCAAGT
TAGTTACAGGG -> AGTTACAGGGT
TAGTTTTAGAG -> AGTTTTAGAGC
TATAGAAACAG -> ATAGAAACAGA
TATCAGCAAGG -> ATCAGCAAGGG
TATCATTGAAG -> ATCATTGAAGT
TATCCAGTACC -> ATCCAGTACCT
TATCCCTACAA -> ATCCCTACAAC
TATCCGACCTC -> ATCCGACCTCA
TATCGAAGCAG -> ATCGAAGCAGG
TATCGAGGGGA -> ATCGAGGGGAG
TATCGGGGGGC -> ATCGGGGGGCC
TATGCGCCCGT -> ATGCGCCCGTA
TATGCTCCGAA -> ATGCTCCGAAC
TATGGAGCGTG -> ATGGAGCGTGG
TATGGCCCATG -> ATGGCCCATGG
TATGTAACCGG -> ATGTAACCGGC
TATTACTCCTC -> ATTACTCCTCA
TATTAGCTAAG -> ATTAGCTAAGT
TATTCGGGCCC -> ATTCGGGCCCG
TATTGAGATCA -> ATTGAGATCAC
TATTGGAGGGG -> ATTGGAGGGGC
TATTTTAGGAA -> ATTTTAGGAAA
TCAAAATCCGC -> CAAAATCCGCT
TCAAACGCTCG -> CAAACGCTCGG
TCAAATCCCCC -> CAAATCCCCCT
TCAACAAGTTG -> CAACAAGTTGT
TCAAGCACGGC -> CAAGCACGGCC
TCAAGCTGTGC -> CAAGCTGTGCT
TCAAGGTCACG -> CAAGGTCACGA
TCAATAGGCAC -> CAATAGGCACC
TCACAAATGAC -> CACAAATGACG
TCACACGTGAC -> CACACGTGACC
TCACATCGTCT -> CACATCGTCTG
TCACCTAGTTA -> CACCTAGTTAC
TCACGAAATGT -> CACGAAATGTT
TCACGATACCA -> CACGATACCAA
TCACGGCTCCG -> CACGGCTCCGG
TCACGGTCTAG -> CACGGTCTAGG
TCACTGCTCTG -> CACTGCTCTGA
TCAGACACGCT -> CAGACACGCTC
TCAGAGTCCAG -> CAGAGTCCAGG
TCAGATCGGAA -> CAGATCGGAAG
TCAGATCTGAC -> CAGATCTGACA
TCAGCAAGGGC -> CAGCAAGGGCG
TCAGCCGACAC -> CAGCCGACACG
TCAGCTGGTGC -> CAGCTGGTGCT
TCAGGACTTAC -> CAGGACTTACC
TCAGGGGTGTT -> CAGGGGTGTTA
TCAGTATCCGA -> CAGTATCCGAC
TCAGTCCGCCC -> CAGTCCGCCCA
TCAGTTTGTTC -> CAGTTTGTTCA
TCATACGGCCG -> CATACGGCCGA
TCATCAAGGTC -> CATCAAGGTCA
TCATCATGACA -> CATCATGACAG
TCATCCACTCA -> CATCCACTCAG
TCATCTACAAT -> CATCTACAATC
TCATCTTTTTC -> CATCTTTTTCC
TCATGACAGCT -> CATGACAGCTC
TCATGCAGAAC -> CATGCAGAACC
TCATTACGTTT -> CATTACGTTTG
TCATTGAAGTT -> CATTGAAGTTC
TCCAAAATCAC -> CCAAAATCACT
TCCAATTATCC -> CCAATTATCCA
TCCACAGGCCA -> CCACAGGCCAG
TCCACCAGTCG -> CCACCAGTCGC
TCCACGATCGC -> CCACGATCGCG
TCCACTCAGTA -> CCACTCAGTAT
TCCAGCAGGAC -> CCAGCAGGACA
TCCAGCGCTGG -> CCAGCGCTGGC
TCCAGGTCTCA -> CCAGGTCTCAC
TCCAGTACCTG -> CCAGTACCTGA
TCCATCTCCAG -> CCATCTCCAGC
TCCATTGCTGA -> CCATTGCTGAT
TCCCACCCTGG -> CCCACCCTGGT
TCCCAGTGCTT -> CCCAGTGCTTG
TCCCCAAGTGA -> CCCCAAGTGAT
TCCCCAGAAAG -> CCCCAGAAAGC
TCCCCCGTCGT -> CCCCCGTCGTT
TCCCCCGTGGA -> CCCCCGTGGAC
TCCCCCTGAAG -> CCCCCTGAAGC
TCCCGCTCAGA -> CCCGCTCAGAT
TCCCGGTCTCC -> CCCGGTCTCCC
TCCCTACAACC -> CCCTACAACCG
TCCCTCATCTA -> CCCTCATCTAC
TCCCTCCGGTC -> CCCTCCGGTCG
TCCCTGGTATT -> CCCTGGTATTC
TCCCTTTAGGC -> CCCTTTAGGCA
TCCGAACGATT -> CCGAACGATTG
TCCGAAGGGGC -> CCGAAGGGGCG
TCCGACCTCAT -> CCGACCTCATC
TCCGAGAGGGG -> CCGAGAGGGGA
TCCGATCCCCC -> CCGATCCCCCG
TCCGCCCAAGC -> CCGCCCAAGCA
TCCGCTTTAGA -> CCGCTTTAGAT
TCCGGATGAGG -> CCGGATGAGGT
TCCGGCACTCT -> CCGGCACTCTC
TCCGGTCGATC -> CCGGTCGATCC
TCCGTTAGCAC -> CCGTTAGCACA
TCCGTTCCGAT -> CCGTTCCGATC
TCCTAGCGCAT -> CCTAGCGCATA
TCCTAGGCACC -> CCTAGGCACCT
TCCTCATGCAG -> CCTCATGCAGA
TCCTGCGCCTC -> CCTGCGCCTCC
TCCTGCTGAGT -> CCTGCTGAGTA
TCCTTAAATAC -> CCTTAAATACG
TCCTTGATGAG -> CCTTGATGAGC
TCCTTTAAATT -> CCTTTAAATTG
TCGAAAAGCTC -> CGAAAAGCTCA
TCGAAGCAGGC -> CGAAGCAGGCA
TCGACTGGAGC -> CGACTGGAGCT
TCGAGATTTAT -> CGAGATTTATG
TCGAGGGCAAT -> CGAGGGCAATG
TCGAGGGGAGC -> CGAGGGGAGCT
TCGAGTGTCAG -> CGAGTGTCAGA
TCGATCCCCAG -> CGATCCCCAGA
TCGCACACGGT -> CGCACACGGTC
TCGCAGACAAT -> CGCAGACAATT
TCGCATCCGGC -> CGCATCCGGCA
TCGCATTGGTC -> CGCATTGGTCG
TCGCCCAAGCC -> CGCCCAAGCCT
TCGCCTGCAGA -> CGCCTGCAGAT
TCGCCTGCGTT -> CGCCTGCGTTC
TCGCGGCACAC -> CGCGGCACACT
TCGCGTAATTC -> CGCGTAATTCC
TCGCGTTCATA -> CGCGTTCATAC
TCGCTAGCACA -> CGCTAGCACAC
TCGCTCCCGCT -> CGCTCCCGCTC
TCGGAAGTACC -> CGGAAGTACCT
TCGGAGAGTGG -> CGGAGAGTGGT
TCGGAGGGCCA -> CGGAGGGCCAT
TCGGGCAGATA -> CGGGCAGATAC
TCGGGCCCGTT -> CGGGCCCGTTG
TCGGGGGGCCT -> CGGGGGGCCTT
TCGGGTAGACT -> CGGGTAGACTC
TCGGTAGCTTG -> CGGTAGCTTGA
TCGGTCAAGCT -> CGGTCAAGCTG
TCGTCACAAAT -> CGTCACAAATG
TCGTCGGGTAG -> CGTCGGGTAGA
TCGTCTGTGGG -> CGTCTGTGGGG
TCGTGCAGAGC -> CGTGCAGAGCT
TCGTTAAATCG -> CGTTAAATCGC
TCTACAATCGA -> CTACAATCGAG
TCTACCGAACT -> CTACCGAACTT
TCTAGGCTCCA -> CTAGGCTCCAT
TCTCACGGCTC -> CTCACGGCTCC
TCTCCAGCGCT -> CTCCAGCGCTG
TCTCCCCCGTC -> CTCCCCCGTCG
TCTCCCTCATC -> CTCCCTCATCT
TCTCCGTTAGC -> CTCCGTTAGCA
TCTCGAGGGCA -> CTCGAGGGCAA
TCTCGCATTGG -> CTCGCATTGGT
TCTCGTCACAA -> CTCGTCACAAA
TCTCTGGCGGG -> CTCTGGCGGGT
TCTCTTCCTTG -> CTCTTCCTTGA
TCTGACATGTT -> CTGACATGTTG
TCTGATTGCCA -> CTGATTGCCAA
TCTGCGTTTAT -> CTGCGTTTATG
TCTGCTCGACT -> CTGCTCGACTG
TCTGGCGGGTT -> CTGGCGGGTTT
TCTGTCCAATT -> CTGTCCAATTA
TCTGTCGCCTG -> CTGTCGCCTGC
TCTGTGGGGGC -> CTGTGGGGGCG
TCTTAATAGCG -> CTTAATAGCGC
TCTTAGCTACC -> CTTAGCTACCG
TCTTCCTTGAT -> CTTCCTTGATG
TCTTTACTTCA -> CTTTACTTCAT
TCTTTTTCCAG -> CTTTTTCCAGC
TGAACTCGGTC -> GAACTCGGTCA
TGAAGCGGCTG -> GAAGCGGCTGT
TGAAGTTCCAC -> GAAGTTCCACG
TGAATATCAGC -> GAATATCAGCA
TGACACGAGTC -> GACACGAGTCC
TGACAGCTCAC -> GACAGCTCACA
TGACATGTTGG -> GACATGTTGGC
TGACCACCGTT -> GACCACCGTTC
TGACCCCATGC -> GACCCCATGCA
TGACGGTTTAC -> GACGGTTTACT
TGAGAATATTA -> GAGAATATTAC
TGAGACCTGAA -> GAGACCTGAAT
TGAGACGTACT -> GAGACGTACTT
TGAGATCACGG -> GAGATCACGGT
TGAGCAACTGC -> GAGCAACTGCC
TGAGCCACGTA -> GAGCCACGTAA
TGAGCTGCCGT -> GAGCTGCCGTC
TGAGGATGATG -> GAGGATGATGT
TGAGGTAAGTA -> GAGGTAAGTAC
TGAGTAAAATT -> GAGTAAAATTT
TGAGTAACCGC -> GAGTAACCGCA
TGAGTTTCCGA -> GAGTTTCCGAG
TGATAAGCACG -> GATAAGCACGC
TGATACTCATC -> GATACTCATCA
TGATATAGAAA -> GATATAGAAAC
TGATATTGAGA -> GATATTGAGAT
TGATCAGAGTC -> GATCAGAGTCC
TGATCGGAGGG -> GATCGGAGGGC
TGATGAGCTGC -> GATGAGCTGCC
TGATGTCAGAC -> GATGTCAGACA
TGATGTTCTCC -> GATGTTCTCCG
TGATTAGCAGC -> GATTAGCAGCC
TGATTGCCAAA -> GATTGCCAAAT
TGATTGGGAAC -> GATTGGGAACA
TGATTTCAAAA -> GATTTCAAAAT
TGCAAAAGCAA -> GCAAAAGCAAT
TGCAAGATTTC -> GCAAGATTTCG
TGCACCTGGGG -> GCACCTGGGGT
TGCAGAACCGG -> GCAGAACCGGA
TGCAGAGCTCG -> GCAGAGCTCGA
TGCAGATTGAG -> GCAGATTGAGA
TGCAGTCCTGC -> GCAGTCCTGCG
TGCAGTTGACA -> GCAGTTGACAC
TGCATCGCCCA -> GCATCGCCCAA
TGCCAAATGAG -> GCCAAATGAGC
TGCCAGTGGTC -> GCCAGTGGTCT
TGCCCAATGAT -> GCCCAATGATT
TGCCCTCAGCT -> GCCCTCAGCTG
TGCCGGCGCCA -> GCCGGCGCCAG
TGCCGTCTCTG -> GCCGTCTCTGG
TGCCTTCAAAT -> GCCTTCAAATC
TGCCTTCACCT -> GCCTTCACCTA
TGCCTTGTAGT -> GCCTTGTAGTT
TGCGCCCGTAT -> GCGCCCGTATT
TGCGCCTCCTT -> GCGCCTCCTTT
TGCGCGACGAA -> GCGCGACGAAG
TGCGTTCGCAG -> GCGTTCGCAGA
TGCGTTTATGG -> GCGTTTATGGC
TGCTACCTGTG -> GCTACCTGTGG
TGCTCCGAACG -> GCTCCGAACGA
TGCTCGACTGG -> GCTCGACTGGA
TGCTCTGATTG -> GCTCTGATTGC
TGCTGAGTAAC -> GCTGAGTAACC
TGCTGATCAGA -> GCTGATCAGAG
TGCTGCAAAAG -> GCTGCAAAAGC
TGCTGCCGGCG -> GCTGCCGGCGC
TGCTGGGATAA -> GCTGGGATAAC
TGCTTGGGCAA -> GCTTGGGCAAG
TGCTTTCCGTT -> GCTTTCCGTTC
TGCTTTTCCCA -> GCTTTTCCCAC
TGGAACGGCTT -> GGAACGGCTTA
TGGAACTGGGC -> GGAACTGGGCT
TGGACCGTAGA -> GGACCGTAGAC
TGGAGCGTGGA -> GGAGCGTGGAT
TGGAGCTGCCT -> GGAGCTGCCTT
TGGAGGGGCTA -> GGAGGGGCTAT
TGGATAACAAA -> GGATAACAAAA
TGGATCTGTCG -> GGATCTGTCGC
TGGCCCATGGC -> GGCCCATGGCG
TGGCCTCGCAC -> GGCCTCGCACA
TGGCGAACTTT -> GGCGAACTTTC
TGGCGACTGCA -> GGCGACTGCAC
TGGCGGGTTTT -> GGCGGGTTTTC
TGGCTATCGGG -> GGCTATCGGGG
TGGCTCGGTAG -> GGCTCGGTAGC
TGGCTCTCGCA -> GGCTCTCGCAT
TGGGAACACCC -> GGGAACACCCT
TGGGATAACCA -> GGGATAACCAA
TGGGCAAGTAC -> GGGCAAGTACG
TGGGCCGGCGT -> GGGCCGGCGTA
TGGGCTCGTGC -> GGGCTCGTGCA
TGGGGGCGCAG -> GGGGGCGCAGG
TGGGGTACCTC -> GGGGTACCTCC
TGGTATTCGGG -> GGTATTCGGGC
TGGTCGCATCC -> GGTCGCATCCG
TGGTCTGCGTT -> GGTCTGCGTTT
TGGTGAGTTTC -> GGTGAGTTTCC
TGGTGATATTG -> GGTGATATTGA
TGGTGCATCGC -> GGTGCATCGCC
TGGTGCTACCT -> GGTGCTACCTG
TGGTGCTGGGA -> GGTGCTGGGAT
TGTAACCGGCA -> GTAACCGGCAG
TGTACCCTAGA -> GTACCCTAGAT
TGTAGTTTTAG -> GTAGTTTTAGA
TGTCAGACACG -> GTCAGACACGC
TGTCAGATCGG -> GTCAGATCGGA
TGTCAGCCGAC -> GTCAGCCGACA
TGTCCAATTAT -> GTCCAATTATC
TGTCCACAGGC -> GTCCACAGGCC
TGTCGCCTGCA -> GTCGCCTGCAG
TGTCTTTACTT -> GTCTTTACTTC
TGTGAACTCGG -> GTGAACTCGGT
TGTGAGTAAAA -> GTGAGTAAAAT
TGTGATTAGCA -> GTGATTAGCAG
TGTGCCAGTGG -> GTGCCAGTGGT
TGTGCCCTCAG -> GTGCCCTCAGC
TGTGCTGCAAA -> GTGCTGCAAAA
TGTGGAACGGC -> GTGGAACGGCT
TGTGGGGGCGC -> GTGGGGGCGCA
TGTTAACTTCC -> GTTAACTTCCT
TGTTACTAATT -> GTTACTAATTT
TGTTCAATAGG -> GTTCAATAGGC
TGTTCTCCGTT -> GTTCTCCGTTA
TGTTCTGCTCG -> GTTCTGCTCGA
TGTTGGCTCGG -> GTTGGCTCGGT
TGTTGTGTTAC -> GTTGTGTTACG
TTAAACTTGTG -> TAAACTTGTGC
TTAAATACGGG -> TAAATACGGGA
TTAAATCGCCT -> TAAATCGCCTG
TTAAATTGGAA -> TAAATTGGAAC
TTAACTTCCTA -> TAACTTCCTAG
TTAATAGCGCG -> TAATAGCGCGC
TTACAGGGTCC -> TACAGGGTCCG
TTACCATACAG -> TACCATACAGT
TTACGTTTGAT -> TACGTTTGATC
TTACTAATTTC -> TACTAATTTCA
TTACTATGCGC -> TACTATGCGCC
TTACTCAGTCC -> TACTCAGTCCG
TTACTCCTCAT -> TACTCCTCATG
TTACTTCATCT -> TACTTCATCTT
TTAGAGCAATT -> TAGAGCAATTG
TTAGATGCTTT -> TAGATGCTTTC
TTAGCACAGAA -> TAGCACAGAAT
TTAGCAGCCGA -> TAGCAGCCGAC
TTAGCGCGGTG -> TAGCGCGGTGA
TTAGCTAAGTA -> TAGCTAAGTAG
TTAGCTACCGG -> TAGCTACCGGG
TTAGGAAAACA -> TAGGAAAACAC
TTAGGCAGGTG -> TAGGCAGGTGG
TTAGTCCCCAA -> TAGTCCCCAAG
TTATCCAGTAC -> TATCCAGTACC
TTATGCTCCGA -> TATGCTCCGAA
TTATGGAGCGT -> TATGGAGCGTG
TTATGGCCCAT -> TATGGCCCATG
TTATTAGCTAA -> TATTAGCTAAG
TTCAAAATCCG -> TCAAAATCCGC
TTCAAATCCCC -> TCAAATCCCCC
TTCAATAGGCA -> TCAATAGGCAC
TTCACATCGTC -> TCACATCGTCT
TTCACCTAGTT -> TCACCTAGTTA
TTCACGAAATG -> TCACGAAATGT
TTCATACGGCC -> TCATACGGCCG
TTCATCTTTTT -> TCATCTTTTTC
TTCATTACGTT -> TCATTACGTTT
TTCCACCAGTC -> TCCACCAGTCG
TTCCACGATCG -> TCCACGATCGC
TTCCAGCAGGA -> TCCAGCAGGAC
TTCCCACCCTG -> TCCCACCCTGG
TTCCCAGTGCT -> TCCCAGTGCTT
TTCCCTTTAGG -> TCCCTTTAGGC
TTCCGAGAGGG -> TCCGAGAGGGG
TTCCGATCCCC -> TCCGATCCCCC
TTCCGTTCCGA -> TCCGTTCCGAT
TTCCTAGGCAC -> TCCTAGGCACC
TTCCTTGATGA -> TCCTTGATGAG
TTCGAAAAGCT -> TCGAAAAGCTC
TTCGCAGACAA -> TCGCAGACAAT
TTCGCGTTCAT -> TCGCGTTCATA
TTCGGAGAGTG -> TCGGAGAGTGG
TTCGGGCCCGT -> TCGGGCCCGTT
TTCGTCGGGTA -> TCGTCGGGTAG
TTCTCCCTCAT -> TCTCCCTCATC
TTCTCCGTTAG -> TCTCCGTTAGC
TTCTCGTCACA -> TCTCGTCACAA
TTCTCTTCCTT -> TCTCTTCCTTG
TTCTGCTCGAC -> TCTGCTCGACT
TTGAAGTTCCA -> TGAAGTTCCAC
TTGACACGAGT -> TGACACGAGTC
TTGAGAATATT -> TGAGAATATTA
TTGAGATCACG -> TGAGATCACGG
TTGAGGATGAT -> TGAGGATGATG
TTGATAAGCAC -> TGATAAGCACG
TTGATACTCAT -> TGATACTCATC
TTGATCGGAGG -> TGATCGGAGGG
TTGATGAGCTG -> TGATGAGCTGC
TTGCCAAATGA -> TGCCAAATGAG
TTGCCCAATGA -> TGCCCAATGAT
TTGCCTTCACC -> TGCCTTCACCT
TTGCTGATCAG -> TGCTGATCAGA
TTGGAACTGGG -> TGGAACTGGGC
TTGGAGGGGCT -> TGGAGGGGCTA
TTGGCGACTGC -> TGGCGACTGCA
TTGGCTATCGG -> TGGCTATCGGG
TTGGCTCGGTA -> TGGCTCGGTAG
TTGGGAACACC -> TGGGAACACCC
TTGGGCAAGTA -> TGGGCAAGTAC
TTGGTCGCATC -> TGGTCGCATCC
TTGTAGTTTTA -> TGTAGTTTTAG
TTGTCTTTACT -> TGTCTTTACTT
TTGTGAACTCG -> TGTGAACTCGG
TTGTGAGTAAA -> TGTGAGTAAAA
TTGTGATTAGC -> TGTGATTAGCA
TTGTGCCAGTG -> TGTGCCAGTGG
TTGTTCAATAG -> TGTTCAATAGG
TTTAAATTGGA -> TTAAATTGGAA
TTTACTCAGTC -> TTACTCAGTCC
TTTACTTCATC -> TTACTTCATCT
TTTAGAGCAAT -> TTAGAGCAATT
TTTAGATGCTT -> TTAGATGCTTT
TTTAGCGCGGT -> TTAGCGCGGTG
TTTAGGAAAAC -> TTAGGAAAACA
TTTAGGCAGGT -> TTAGGCAGGTG
TTTATGCTCCG -> TTATGCTCCGA
TTTATGGAGCG -> TTATGGAGCGT
TTTATGGCCCA -> TTATGGCCCAT
TTTCAAAATCC -> TTCAAAATCCG
TTTCATTACGT -> TTCATTACGTT
TTTCCAGCAGG -> TTCCAGCAGGA
TTTCCCACCCT -> TTCCCACCCTG
TTTCCCTTTAG -> TTCCCTTTAGG
TTTCCGAGAGG -> TTCCGAGAGGG
TTTCCGTTCCG -> TTCCGTTCCGA
TTTCGCGTTCA -> TTCGCGTTCAT
TTTCGTCGGGT -> TTCGTCGGGTA
TTTCTCCCTCA -> TTCTCCCTCAT
TTTCTCGTCAC -> TTCTCGTCACA
TTTGAGGATGA -> TTGAGGATGAT
TTTGATCGGAG -> TTGATCGGAGG
TTTGGCTATCG -> TTGGCTATCGG
TTTGTGAACTC -> TTGTGAACTCG
TTTGTTCAATA -> TTGTTCAATAG
TTTTAGAGCAA -> TTTAGAGCAAT
TTTTAGGAAAA -> TTTAGGAAAAC
TTTTCCAGCAG -> TTTCCAGCAGG
TTTTCCCACCC -> TTTCCCACCCT
TTTTCGCGTTC -> TTTCGCGTTCA
TTTTTCCAGCA -> TTTTCCAGCAG
